,strain,treatment,cosm,name,contig,start,end,length
0,Agrobacterium tumefaciens,1,1,At11.7,tig00000001_polypolish,1,5075,5074
1,Agrobacterium tumefaciens,1,1,At11.7,tig00000001_polypolish,5079,5080,1
2,Agrobacterium tumefaciens,1,1,At11.7,tig00000001_polypolish,5203,5204,1
3,Agrobacterium tumefaciens,1,1,At11.7,tig00000001_polypolish,5303,5304,1
4,Agrobacterium tumefaciens,1,1,At11.7,tig00000001_polypolish,5327,5328,1
5,Agrobacterium tumefaciens,1,1,At11.7,tig00000001_polypolish,5340,5342,2
6,Agrobacterium tumefaciens,1,1,At11.7,tig00000001_polypolish,5784,5785,1
7,Agrobacterium tumefaciens,1,1,At11.7,tig00000001_polypolish,667555,667556,1
8,Agrobacterium tumefaciens,1,1,At11.7,tig00000001_polypolish,910408,910409,1
9,Agrobacterium tumefaciens,1,1,At11.7,tig00000001_polypolish,1065215,1065216,1
10,Agrobacterium tumefaciens,1,1,At11.7,tig00000001_polypolish,1528525,1528526,1
11,Agrobacterium tumefaciens,1,1,At11.7,tig00000001_polypolish,1988294,1988295,1
12,Agrobacterium tumefaciens,1,1,At11.7,tig00000001_polypolish,2997159,2999962,2803
13,Agrobacterium tumefaciens,1,1,At11.7,tig00000002_polypolish,169280,169281,1
14,Agrobacterium tumefaciens,1,1,At11.7,tig00000002_polypolish,780127,780128,1
15,Agrobacterium tumefaciens,1,1,At11.7,tig00000002_polypolish,1201507,1201508,1
16,Agrobacterium tumefaciens,1,1,At11.7,tig00000003_polypolish,0,548,548
17,Agrobacterium tumefaciens,1,1,At11.7,tig00000003_polypolish,5798,5799,1
18,Agrobacterium tumefaciens,1,1,At11.7,tig00000003_polypolish,16329,16330,1
19,Agrobacterium tumefaciens,1,1,At11.7,tig00000003_polypolish,55802,55803,1
20,Agrobacterium tumefaciens,1,1,At11.7,tig00000003_polypolish,74805,74806,1
21,Agrobacterium tumefaciens,1,1,At11.7,tig00000003_polypolish,120464,120465,1
22,Agrobacterium tumefaciens,1,1,At11.7,tig00000003_polypolish,132437,132438,1
23,Agrobacterium tumefaciens,1,1,At11.7,tig00000003_polypolish,205119,205120,1
24,Agrobacterium tumefaciens,1,1,At11.7,tig00000003_polypolish,208819,208820,1
25,Agrobacterium tumefaciens,1,1,At11.7,tig00000003_polypolish,210510,210512,2
26,Agrobacterium tumefaciens,1,1,At11.7,tig00000003_polypolish,211045,211048,3
27,Agrobacterium tumefaciens,1,1,At11.7,tig00000003_polypolish,211830,213991,2161
28,Agrobacterium tumefaciens,1,1,At11.7,tig00000004_polypolish,0,1827,1827
29,Agrobacterium tumefaciens,1,1,At11.7,tig00000004_polypolish,2004,2005,1
30,Agrobacterium tumefaciens,1,1,At11.7,tig00000004_polypolish,2007,2009,2
31,Agrobacterium tumefaciens,1,1,At11.7,tig00000004_polypolish,2849,2851,2
32,Agrobacterium tumefaciens,1,1,At11.7,tig00000004_polypolish,4645,4646,1
33,Agrobacterium tumefaciens,1,1,At11.7,tig00000004_polypolish,4831,4832,1
34,Agrobacterium tumefaciens,1,1,At11.7,tig00000004_polypolish,5222,5223,1
35,Agrobacterium tumefaciens,1,1,At11.7,tig00000004_polypolish,6100,6101,1
36,Agrobacterium tumefaciens,1,1,At11.7,tig00000004_polypolish,7944,7945,1
37,Agrobacterium tumefaciens,1,1,At11.7,tig00000004_polypolish,8779,8780,1
38,Agrobacterium tumefaciens,1,1,At11.7,tig00000004_polypolish,8862,8863,1
39,Agrobacterium tumefaciens,1,1,At11.7,tig00000004_polypolish,8928,8929,1
40,Agrobacterium tumefaciens,1,1,At11.7,tig00000004_polypolish,10284,10285,1
41,Agrobacterium tumefaciens,1,1,At11.7,tig00000004_polypolish,10308,10309,1
42,Agrobacterium tumefaciens,1,1,At11.7,tig00000004_polypolish,10446,10447,1
43,Agrobacterium tumefaciens,1,1,At11.7,tig00000004_polypolish,10639,10640,1
44,Agrobacterium tumefaciens,1,1,At11.7,tig00000004_polypolish,10889,10890,1
45,Agrobacterium tumefaciens,1,1,At11.7,tig00000004_polypolish,11000,11003,3
46,Agrobacterium tumefaciens,1,1,At11.7,tig00000004_polypolish,11694,11695,1
47,Agrobacterium tumefaciens,1,1,At11.7,tig00000004_polypolish,11702,11703,1
48,Agrobacterium tumefaciens,1,1,At11.7,tig00000004_polypolish,11868,11870,2
49,Agrobacterium tumefaciens,1,1,At11.7,tig00000004_polypolish,11883,11884,1
50,Agrobacterium tumefaciens,1,1,At11.7,tig00000004_polypolish,11886,11887,1
51,Agrobacterium tumefaciens,1,1,At11.7,tig00000004_polypolish,12795,12796,1
52,Agrobacterium tumefaciens,1,1,At11.7,tig00000004_polypolish,14237,14238,1
53,Agrobacterium tumefaciens,1,1,At11.7,tig00000004_polypolish,14858,14859,1
54,Agrobacterium tumefaciens,1,1,At11.7,tig00000004_polypolish,14862,14863,1
55,Agrobacterium tumefaciens,1,1,At11.7,tig00000004_polypolish,15800,15801,1
56,Agrobacterium tumefaciens,1,1,At11.7,tig00000004_polypolish,15864,15865,1
57,Agrobacterium tumefaciens,1,1,At11.7,tig00000004_polypolish,16029,16030,1
58,Agrobacterium tumefaciens,1,1,At11.7,tig00000004_polypolish,16112,16113,1
59,Agrobacterium tumefaciens,1,1,At11.7,tig00000004_polypolish,16552,16553,1
60,Agrobacterium tumefaciens,1,1,At11.7,tig00000004_polypolish,17316,17317,1
61,Agrobacterium tumefaciens,1,1,At11.7,tig00000004_polypolish,19043,19044,1
62,Agrobacterium tumefaciens,1,1,At11.7,tig00000004_polypolish,19071,19072,1
63,Agrobacterium tumefaciens,1,1,At11.7,tig00000004_polypolish,19112,19113,1
64,Agrobacterium tumefaciens,1,1,At11.7,tig00000004_polypolish,19320,19321,1
65,Agrobacterium tumefaciens,1,1,At11.7,tig00000004_polypolish,19554,19555,1
66,Agrobacterium tumefaciens,1,1,At11.7,tig00000004_polypolish,54907,54908,1
67,Agrobacterium tumefaciens,1,1,At11.7,tig00000004_polypolish,55164,55165,1
68,Agrobacterium tumefaciens,1,1,At11.7,tig00000004_polypolish,55174,55175,1
69,Agrobacterium tumefaciens,1,1,At11.7,tig00000004_polypolish,55376,55377,1
70,Agrobacterium tumefaciens,1,1,At11.7,tig00000004_polypolish,55471,55472,1
71,Agrobacterium tumefaciens,1,1,At11.7,tig00000004_polypolish,56089,56090,1
72,Agrobacterium tumefaciens,1,1,At11.7,tig00000004_polypolish,59234,59235,1
73,Agrobacterium tumefaciens,1,1,At11.7,tig00000004_polypolish,62920,62921,1
74,Agrobacterium tumefaciens,1,1,At11.7,tig00000004_polypolish,86489,86490,1
75,Agrobacterium tumefaciens,1,1,At11.7,tig00000004_polypolish,88998,88999,1
76,Agrobacterium tumefaciens,1,1,At11.7,tig00000004_polypolish,89239,89240,1
77,Agrobacterium tumefaciens,1,1,At11.7,tig00000004_polypolish,89257,89258,1
78,Agrobacterium tumefaciens,1,1,At11.7,tig00000004_polypolish,89315,89316,1
79,Agrobacterium tumefaciens,1,1,At11.7,tig00000004_polypolish,89861,89862,1
80,Agrobacterium tumefaciens,1,1,At11.7,tig00000004_polypolish,89990,89991,1
81,Agrobacterium tumefaciens,1,1,At11.7,tig00000004_polypolish,90041,90042,1
82,Agrobacterium tumefaciens,1,1,At11.7,tig00000004_polypolish,90279,90280,1
83,Agrobacterium tumefaciens,1,1,At11.7,tig00000004_polypolish,90417,90418,1
84,Agrobacterium tumefaciens,1,1,At11.7,tig00000004_polypolish,90745,90746,1
85,Agrobacterium tumefaciens,1,1,At11.7,tig00000004_polypolish,91684,91685,1
86,Agrobacterium tumefaciens,1,1,At11.7,tig00000004_polypolish,91838,91839,1
87,Agrobacterium tumefaciens,1,1,At11.7,tig00000004_polypolish,98294,98295,1
88,Agrobacterium tumefaciens,1,1,At11.7,tig00000004_polypolish,100771,100772,1
89,Agrobacterium tumefaciens,1,1,At11.7,tig00000004_polypolish,103191,103192,1
90,Agrobacterium tumefaciens,1,1,At11.7,tig00000004_polypolish,115263,115264,1
91,Agrobacterium tumefaciens,1,1,At11.7,tig00000004_polypolish,116307,116308,1
92,Agrobacterium tumefaciens,1,1,At11.7,tig00000004_polypolish,116372,116373,1
93,Agrobacterium tumefaciens,1,1,At11.7,tig00000004_polypolish,116430,116431,1
94,Agrobacterium tumefaciens,1,1,At11.7,tig00000004_polypolish,125161,125162,1
95,Agrobacterium tumefaciens,1,1,At11.7,tig00000004_polypolish,175813,175814,1
96,Agrobacterium tumefaciens,1,1,At11.7,tig00000004_polypolish,176357,176358,1
97,Agrobacterium tumefaciens,1,1,At11.7,tig00000004_polypolish,215729,215730,1
98,Agrobacterium tumefaciens,1,1,At11.7,tig00000004_polypolish,215895,215896,1
99,Agrobacterium tumefaciens,1,1,At11.7,tig00000004_polypolish,216360,216361,1
100,Agrobacterium tumefaciens,1,1,At11.7,tig00000004_polypolish,216700,216701,1
101,Agrobacterium tumefaciens,1,1,At11.7,tig00000004_polypolish,216872,216873,1
102,Agrobacterium tumefaciens,1,1,At11.7,tig00000004_polypolish,217498,217500,2
103,Agrobacterium tumefaciens,1,1,At11.7,tig00000004_polypolish,217801,217802,1
104,Agrobacterium tumefaciens,1,1,At11.7,tig00000004_polypolish,218657,218658,1
105,Agrobacterium tumefaciens,1,1,At11.7,tig00000004_polypolish,220575,224717,4142
106,Agrobacterium tumefaciens,1,1,At11.7,tig00000004_polypolish,224746,224747,1
107,Agrobacterium tumefaciens,1,1,At11.7,tig00000004_polypolish,224760,224761,1
108,Agrobacterium tumefaciens,1,1,At11.7,tig00000004_polypolish,224935,224936,1
109,Agrobacterium tumefaciens,1,1,At11.7,tig00000004_polypolish,225222,229503,4281
110,Agrobacterium tumefaciens,1,1,At11.7,tig00000005_polypolish,0,31114,31114
111,Agrobacterium tumefaciens,1,1,At11.8,tig00000001_polypolish,1,3435,3434
112,Agrobacterium tumefaciens,1,1,At11.8,tig00000001_polypolish,5081,5085,4
113,Agrobacterium tumefaciens,1,1,At11.8,tig00000001_polypolish,5211,5212,1
114,Agrobacterium tumefaciens,1,1,At11.8,tig00000001_polypolish,261913,261914,1
115,Agrobacterium tumefaciens,1,1,At11.8,tig00000001_polypolish,264233,264234,1
116,Agrobacterium tumefaciens,1,1,At11.8,tig00000001_polypolish,618755,618756,1
117,Agrobacterium tumefaciens,1,1,At11.8,tig00000001_polypolish,2536385,2536386,1
118,Agrobacterium tumefaciens,1,1,At11.8,tig00000001_polypolish,2998692,2998693,1
119,Agrobacterium tumefaciens,1,1,At11.8,tig00000001_polypolish,2998715,2998717,2
120,Agrobacterium tumefaciens,1,1,At11.8,tig00000001_polypolish,2998734,2999962,1228
121,Agrobacterium tumefaciens,1,1,At11.8,tig00000003_polypolish,0,2104,2104
122,Agrobacterium tumefaciens,1,1,At11.8,tig00000003_polypolish,23366,23367,1
123,Agrobacterium tumefaciens,1,1,At11.8,tig00000003_polypolish,203409,203410,1
124,Agrobacterium tumefaciens,1,1,At11.8,tig00000003_polypolish,203490,203491,1
125,Agrobacterium tumefaciens,1,1,At11.8,tig00000003_polypolish,203518,203519,1
126,Agrobacterium tumefaciens,1,1,At11.8,tig00000003_polypolish,203538,203539,1
127,Agrobacterium tumefaciens,1,1,At11.8,tig00000003_polypolish,204090,204091,1
128,Agrobacterium tumefaciens,1,1,At11.8,tig00000003_polypolish,204316,204317,1
129,Agrobacterium tumefaciens,1,1,At11.8,tig00000003_polypolish,204470,204471,1
130,Agrobacterium tumefaciens,1,1,At11.8,tig00000003_polypolish,204481,204482,1
131,Agrobacterium tumefaciens,1,1,At11.8,tig00000003_polypolish,204661,204662,1
132,Agrobacterium tumefaciens,1,1,At11.8,tig00000003_polypolish,204759,204762,3
133,Agrobacterium tumefaciens,1,1,At11.8,tig00000003_polypolish,204992,204993,1
134,Agrobacterium tumefaciens,1,1,At11.8,tig00000003_polypolish,205048,205049,1
135,Agrobacterium tumefaciens,1,1,At11.8,tig00000003_polypolish,205237,205238,1
136,Agrobacterium tumefaciens,1,1,At11.8,tig00000003_polypolish,205745,205746,1
137,Agrobacterium tumefaciens,1,1,At11.8,tig00000003_polypolish,206087,206088,1
138,Agrobacterium tumefaciens,1,1,At11.8,tig00000003_polypolish,207223,207224,1
139,Agrobacterium tumefaciens,1,1,At11.8,tig00000003_polypolish,208132,208133,1
140,Agrobacterium tumefaciens,1,1,At11.8,tig00000003_polypolish,208219,208220,1
141,Agrobacterium tumefaciens,1,1,At11.8,tig00000003_polypolish,210068,210069,1
142,Agrobacterium tumefaciens,1,1,At11.8,tig00000003_polypolish,210325,210326,1
143,Agrobacterium tumefaciens,1,1,At11.8,tig00000003_polypolish,210441,210442,1
144,Agrobacterium tumefaciens,1,1,At11.8,tig00000003_polypolish,210765,210766,1
145,Agrobacterium tumefaciens,1,1,At11.8,tig00000003_polypolish,211390,213991,2601
146,Agrobacterium tumefaciens,1,1,At11.8,tig00000004_polypolish,0,2511,2511
147,Agrobacterium tumefaciens,1,1,At11.8,tig00000004_polypolish,2525,2526,1
148,Agrobacterium tumefaciens,1,1,At11.8,tig00000004_polypolish,2676,2677,1
149,Agrobacterium tumefaciens,1,1,At11.8,tig00000004_polypolish,2935,2936,1
150,Agrobacterium tumefaciens,1,1,At11.8,tig00000004_polypolish,3619,3620,1
151,Agrobacterium tumefaciens,1,1,At11.8,tig00000004_polypolish,4019,4020,1
152,Agrobacterium tumefaciens,1,1,At11.8,tig00000004_polypolish,4514,4515,1
153,Agrobacterium tumefaciens,1,1,At11.8,tig00000004_polypolish,4645,4646,1
154,Agrobacterium tumefaciens,1,1,At11.8,tig00000004_polypolish,4974,4975,1
155,Agrobacterium tumefaciens,1,1,At11.8,tig00000004_polypolish,5503,5504,1
156,Agrobacterium tumefaciens,1,1,At11.8,tig00000004_polypolish,5726,5727,1
157,Agrobacterium tumefaciens,1,1,At11.8,tig00000004_polypolish,6092,6093,1
158,Agrobacterium tumefaciens,1,1,At11.8,tig00000004_polypolish,6105,6106,1
159,Agrobacterium tumefaciens,1,1,At11.8,tig00000004_polypolish,122655,122656,1
160,Agrobacterium tumefaciens,1,1,At11.8,tig00000004_polypolish,224018,224019,1
161,Agrobacterium tumefaciens,1,1,At11.8,tig00000004_polypolish,224202,224203,1
162,Agrobacterium tumefaciens,1,1,At11.8,tig00000004_polypolish,224527,224528,1
163,Agrobacterium tumefaciens,1,1,At11.8,tig00000004_polypolish,224695,224697,2
164,Agrobacterium tumefaciens,1,1,At11.8,tig00000004_polypolish,224780,224781,1
165,Agrobacterium tumefaciens,1,1,At11.8,tig00000004_polypolish,225790,225791,1
166,Agrobacterium tumefaciens,1,1,At11.8,tig00000004_polypolish,225881,229503,3622
167,Agrobacterium tumefaciens,1,1,At11.8,tig00000005_polypolish,0,9249,9249
168,Agrobacterium tumefaciens,1,1,At11.8,tig00000005_polypolish,9383,9384,1
169,Agrobacterium tumefaciens,1,1,At11.8,tig00000005_polypolish,9436,9438,2
170,Agrobacterium tumefaciens,1,1,At11.8,tig00000005_polypolish,9470,9471,1
171,Agrobacterium tumefaciens,1,1,At11.8,tig00000005_polypolish,9503,9504,1
172,Agrobacterium tumefaciens,1,1,At11.8,tig00000005_polypolish,9722,9723,1
173,Agrobacterium tumefaciens,1,1,At11.8,tig00000005_polypolish,9798,9799,1
174,Agrobacterium tumefaciens,1,1,At11.8,tig00000005_polypolish,10531,10532,1
175,Agrobacterium tumefaciens,1,1,At11.8,tig00000005_polypolish,10553,10554,1
176,Agrobacterium tumefaciens,1,1,At11.8,tig00000005_polypolish,11194,11195,1
177,Agrobacterium tumefaciens,1,1,At11.8,tig00000005_polypolish,11301,11302,1
178,Agrobacterium tumefaciens,1,1,At11.8,tig00000005_polypolish,12191,12192,1
179,Agrobacterium tumefaciens,1,1,At11.8,tig00000005_polypolish,12468,12469,1
180,Agrobacterium tumefaciens,1,1,At11.8,tig00000005_polypolish,12533,12534,1
181,Agrobacterium tumefaciens,1,1,At11.8,tig00000005_polypolish,12726,12727,1
182,Agrobacterium tumefaciens,1,1,At11.8,tig00000005_polypolish,13012,13013,1
183,Agrobacterium tumefaciens,1,1,At11.8,tig00000005_polypolish,13073,13074,1
184,Agrobacterium tumefaciens,1,1,At11.8,tig00000005_polypolish,13114,13115,1
185,Agrobacterium tumefaciens,1,1,At11.8,tig00000005_polypolish,13264,13265,1
186,Agrobacterium tumefaciens,1,1,At11.8,tig00000005_polypolish,13713,13714,1
187,Agrobacterium tumefaciens,1,1,At11.8,tig00000005_polypolish,14127,14128,1
188,Agrobacterium tumefaciens,1,1,At11.8,tig00000005_polypolish,14135,14136,1
189,Agrobacterium tumefaciens,1,1,At11.8,tig00000005_polypolish,14583,14584,1
190,Agrobacterium tumefaciens,1,1,At11.8,tig00000005_polypolish,14859,14860,1
191,Agrobacterium tumefaciens,1,1,At11.8,tig00000005_polypolish,15254,15255,1
192,Agrobacterium tumefaciens,1,1,At11.8,tig00000005_polypolish,16194,16195,1
193,Agrobacterium tumefaciens,1,1,At11.8,tig00000005_polypolish,17051,17052,1
194,Agrobacterium tumefaciens,1,1,At11.8,tig00000005_polypolish,18191,18192,1
195,Agrobacterium tumefaciens,1,1,At11.8,tig00000005_polypolish,18290,18291,1
196,Agrobacterium tumefaciens,1,1,At11.8,tig00000005_polypolish,19831,19832,1
197,Agrobacterium tumefaciens,1,1,At11.8,tig00000005_polypolish,20921,20922,1
198,Agrobacterium tumefaciens,1,1,At11.8,tig00000005_polypolish,21053,21054,1
199,Agrobacterium tumefaciens,1,1,At11.8,tig00000005_polypolish,21165,21166,1
200,Agrobacterium tumefaciens,1,1,At11.8,tig00000005_polypolish,21626,21627,1
201,Agrobacterium tumefaciens,1,1,At11.8,tig00000005_polypolish,21979,21980,1
202,Agrobacterium tumefaciens,1,1,At11.8,tig00000005_polypolish,22209,22210,1
203,Agrobacterium tumefaciens,1,1,At11.8,tig00000005_polypolish,23000,23001,1
204,Agrobacterium tumefaciens,1,1,At11.8,tig00000005_polypolish,23622,23623,1
205,Agrobacterium tumefaciens,1,1,At11.8,tig00000005_polypolish,23817,23818,1
206,Agrobacterium tumefaciens,1,1,At11.8,tig00000005_polypolish,23985,23986,1
207,Agrobacterium tumefaciens,1,1,At11.8,tig00000005_polypolish,24135,24136,1
208,Agrobacterium tumefaciens,1,1,At11.8,tig00000005_polypolish,24478,24479,1
209,Agrobacterium tumefaciens,1,1,At11.8,tig00000005_polypolish,24716,24717,1
210,Agrobacterium tumefaciens,1,1,At11.8,tig00000005_polypolish,24720,24721,1
211,Agrobacterium tumefaciens,1,1,At11.8,tig00000005_polypolish,25239,25240,1
212,Agrobacterium tumefaciens,1,1,At11.8,tig00000005_polypolish,25394,25395,1
213,Agrobacterium tumefaciens,1,1,At11.8,tig00000005_polypolish,25511,25512,1
214,Agrobacterium tumefaciens,1,1,At11.8,tig00000005_polypolish,25543,25544,1
215,Agrobacterium tumefaciens,1,1,At11.8,tig00000005_polypolish,25974,25975,1
216,Agrobacterium tumefaciens,1,1,At11.8,tig00000005_polypolish,26202,26203,1
217,Agrobacterium tumefaciens,1,1,At11.8,tig00000005_polypolish,26306,26307,1
218,Agrobacterium tumefaciens,1,1,At11.8,tig00000005_polypolish,26423,26424,1
219,Agrobacterium tumefaciens,1,1,At11.8,tig00000005_polypolish,26513,26514,1
220,Agrobacterium tumefaciens,1,1,At11.8,tig00000005_polypolish,26520,26521,1
221,Agrobacterium tumefaciens,1,1,At11.8,tig00000005_polypolish,27032,27033,1
222,Agrobacterium tumefaciens,1,1,At11.8,tig00000005_polypolish,27143,27144,1
223,Agrobacterium tumefaciens,1,1,At11.8,tig00000005_polypolish,27215,27216,1
224,Agrobacterium tumefaciens,1,1,At11.8,tig00000005_polypolish,27296,27297,1
225,Agrobacterium tumefaciens,1,1,At11.8,tig00000005_polypolish,27305,27306,1
226,Agrobacterium tumefaciens,1,1,At11.8,tig00000005_polypolish,27355,31114,3759
227,Agrobacterium tumefaciens,1,2,At12.1,tig00000001_polypolish,1,1122,1121
228,Agrobacterium tumefaciens,1,2,At12.1,tig00000001_polypolish,726388,726389,1
229,Agrobacterium tumefaciens,1,2,At12.1,tig00000001_polypolish,2995962,2995963,1
230,Agrobacterium tumefaciens,1,2,At12.1,tig00000001_polypolish,2997283,2997284,1
231,Agrobacterium tumefaciens,1,2,At12.1,tig00000001_polypolish,2997908,2997909,1
232,Agrobacterium tumefaciens,1,2,At12.1,tig00000001_polypolish,2997941,2997943,2
233,Agrobacterium tumefaciens,1,2,At12.1,tig00000001_polypolish,2998214,2998215,1
234,Agrobacterium tumefaciens,1,2,At12.1,tig00000001_polypolish,2998385,2999962,1577
235,Agrobacterium tumefaciens,1,2,At12.1,tig00000003_polypolish,0,3408,3408
236,Agrobacterium tumefaciens,1,2,At12.1,tig00000003_polypolish,4809,4812,3
237,Agrobacterium tumefaciens,1,2,At12.1,tig00000003_polypolish,210997,210998,1
238,Agrobacterium tumefaciens,1,2,At12.1,tig00000003_polypolish,213453,213454,1
239,Agrobacterium tumefaciens,1,2,At12.1,tig00000003_polypolish,213553,213555,2
240,Agrobacterium tumefaciens,1,2,At12.1,tig00000003_polypolish,213565,213566,1
241,Agrobacterium tumefaciens,1,2,At12.1,tig00000003_polypolish,213693,213694,1
242,Agrobacterium tumefaciens,1,2,At12.1,tig00000003_polypolish,213842,213843,1
243,Agrobacterium tumefaciens,1,2,At12.1,tig00000003_polypolish,213941,213991,50
244,Agrobacterium tumefaciens,1,2,At12.1,tig00000004_polypolish,0,2918,2918
245,Agrobacterium tumefaciens,1,2,At12.1,tig00000004_polypolish,183854,183855,1
246,Agrobacterium tumefaciens,1,2,At12.1,tig00000004_polypolish,225057,229503,4446
247,Agrobacterium tumefaciens,1,2,At12.1,tig00000005_polypolish,1927,1928,1
248,Agrobacterium tumefaciens,1,2,At12.1,tig00000005_polypolish,6982,6983,1
249,Agrobacterium tumefaciens,1,2,At12.1,tig00000005_polypolish,11107,11108,1
250,Agrobacterium tumefaciens,1,2,At12.1,tig00000005_polypolish,11402,11403,1
251,Agrobacterium tumefaciens,1,2,At12.1,tig00000005_polypolish,11681,11682,1
252,Agrobacterium tumefaciens,1,2,At12.1,tig00000005_polypolish,12568,12569,1
253,Agrobacterium tumefaciens,1,2,At12.1,tig00000005_polypolish,12797,12798,1
254,Agrobacterium tumefaciens,1,2,At12.1,tig00000005_polypolish,17363,17364,1
255,Agrobacterium tumefaciens,1,2,At12.1,tig00000005_polypolish,17738,17739,1
256,Agrobacterium tumefaciens,1,2,At12.1,tig00000005_polypolish,18002,18003,1
257,Agrobacterium tumefaciens,1,2,At12.1,tig00000005_polypolish,18504,18505,1
258,Agrobacterium tumefaciens,1,2,At12.1,tig00000005_polypolish,19203,19204,1
259,Agrobacterium tumefaciens,1,2,At12.1,tig00000005_polypolish,20684,20685,1
260,Agrobacterium tumefaciens,1,2,At12.1,tig00000005_polypolish,26515,26516,1
261,Agrobacterium tumefaciens,1,2,At12.1,tig00000005_polypolish,27937,27938,1
262,Agrobacterium tumefaciens,1,2,At12.1,tig00000005_polypolish,28122,28123,1
263,Agrobacterium tumefaciens,3,1,At31.1,tig00000001_polypolish,1,651,650
264,Agrobacterium tumefaciens,3,1,At31.1,tig00000001_polypolish,61071,61083,12
265,Agrobacterium tumefaciens,3,1,At31.1,tig00000001_polypolish,1129182,1129183,1
266,Agrobacterium tumefaciens,3,1,At31.1,tig00000001_polypolish,1196725,1197891,1166
267,Agrobacterium tumefaciens,3,1,At31.1,tig00000001_polypolish,2995962,2995963,1
268,Agrobacterium tumefaciens,3,1,At31.1,tig00000001_polypolish,2996619,2996620,1
269,Agrobacterium tumefaciens,3,1,At31.1,tig00000001_polypolish,2996771,2996772,1
270,Agrobacterium tumefaciens,3,1,At31.1,tig00000001_polypolish,2996836,2999962,3126
271,Agrobacterium tumefaciens,3,1,At31.1,tig00000002_polypolish,1660298,1660299,1
272,Agrobacterium tumefaciens,3,1,At31.1,tig00000003_polypolish,0,11979,11979
273,Agrobacterium tumefaciens,3,1,At31.1,tig00000003_polypolish,14598,200769,186171
274,Agrobacterium tumefaciens,3,1,At31.1,tig00000003_polypolish,203388,213991,10603
275,Agrobacterium tumefaciens,3,1,At31.1,tig00000004_polypolish,0,4174,4174
276,Agrobacterium tumefaciens,3,1,At31.1,tig00000004_polypolish,4330,4331,1
277,Agrobacterium tumefaciens,3,1,At31.1,tig00000004_polypolish,4580,4581,1
278,Agrobacterium tumefaciens,3,1,At31.1,tig00000004_polypolish,4641,4642,1
279,Agrobacterium tumefaciens,3,1,At31.1,tig00000004_polypolish,4699,4701,2
280,Agrobacterium tumefaciens,3,1,At31.1,tig00000004_polypolish,4884,4885,1
281,Agrobacterium tumefaciens,3,1,At31.1,tig00000004_polypolish,5158,5159,1
282,Agrobacterium tumefaciens,3,1,At31.1,tig00000004_polypolish,5327,5328,1
283,Agrobacterium tumefaciens,3,1,At31.1,tig00000004_polypolish,5552,5554,2
284,Agrobacterium tumefaciens,3,1,At31.1,tig00000004_polypolish,5643,5644,1
285,Agrobacterium tumefaciens,3,1,At31.1,tig00000004_polypolish,5728,5729,1
286,Agrobacterium tumefaciens,3,1,At31.1,tig00000004_polypolish,7164,7165,1
287,Agrobacterium tumefaciens,3,1,At31.1,tig00000004_polypolish,7457,7458,1
288,Agrobacterium tumefaciens,3,1,At31.1,tig00000004_polypolish,78739,78749,10
289,Agrobacterium tumefaciens,3,1,At31.1,tig00000004_polypolish,225784,225785,1
290,Agrobacterium tumefaciens,3,1,At31.1,tig00000004_polypolish,226122,226123,1
291,Agrobacterium tumefaciens,3,1,At31.1,tig00000004_polypolish,226195,226196,1
292,Agrobacterium tumefaciens,3,1,At31.1,tig00000004_polypolish,226222,226223,1
293,Agrobacterium tumefaciens,3,1,At31.1,tig00000004_polypolish,226256,226257,1
294,Agrobacterium tumefaciens,3,1,At31.1,tig00000004_polypolish,226412,226413,1
295,Agrobacterium tumefaciens,3,1,At31.1,tig00000004_polypolish,226440,229503,3063
296,Agrobacterium tumefaciens,3,1,At31.1,tig00000005_polypolish,0,31114,31114
297,Agrobacterium tumefaciens,3,2,At32.1,tig00000001_polypolish,1,1876,1875
298,Agrobacterium tumefaciens,3,2,At32.1,tig00000001_polypolish,61071,61083,12
299,Agrobacterium tumefaciens,3,2,At32.1,tig00000001_polypolish,1231305,1231308,3
300,Agrobacterium tumefaciens,3,2,At32.1,tig00000001_polypolish,1327755,1327756,1
301,Agrobacterium tumefaciens,3,2,At32.1,tig00000001_polypolish,1367446,1367447,1
302,Agrobacterium tumefaciens,3,2,At32.1,tig00000001_polypolish,1500584,1500585,1
303,Agrobacterium tumefaciens,3,2,At32.1,tig00000001_polypolish,1500662,1500663,1
304,Agrobacterium tumefaciens,3,2,At32.1,tig00000001_polypolish,1562423,1562424,1
305,Agrobacterium tumefaciens,3,2,At32.1,tig00000001_polypolish,1934609,1934610,1
306,Agrobacterium tumefaciens,3,2,At32.1,tig00000001_polypolish,2184703,2184772,69
307,Agrobacterium tumefaciens,3,2,At32.1,tig00000001_polypolish,2921438,2921439,1
308,Agrobacterium tumefaciens,3,2,At32.1,tig00000001_polypolish,2995776,2995777,1
309,Agrobacterium tumefaciens,3,2,At32.1,tig00000001_polypolish,2996732,2996733,1
310,Agrobacterium tumefaciens,3,2,At32.1,tig00000001_polypolish,2997346,2997347,1
311,Agrobacterium tumefaciens,3,2,At32.1,tig00000001_polypolish,2997554,2997555,1
312,Agrobacterium tumefaciens,3,2,At32.1,tig00000001_polypolish,2997620,2997621,1
313,Agrobacterium tumefaciens,3,2,At32.1,tig00000001_polypolish,2997946,2997947,1
314,Agrobacterium tumefaciens,3,2,At32.1,tig00000001_polypolish,2997952,2997953,1
315,Agrobacterium tumefaciens,3,2,At32.1,tig00000001_polypolish,2998190,2998191,1
316,Agrobacterium tumefaciens,3,2,At32.1,tig00000001_polypolish,2998203,2999962,1759
317,Agrobacterium tumefaciens,3,2,At32.1,tig00000003_polypolish,0,3197,3197
318,Agrobacterium tumefaciens,3,2,At32.1,tig00000003_polypolish,7409,7410,1
319,Agrobacterium tumefaciens,3,2,At32.1,tig00000003_polypolish,15187,15188,1
320,Agrobacterium tumefaciens,3,2,At32.1,tig00000003_polypolish,41905,41906,1
321,Agrobacterium tumefaciens,3,2,At32.1,tig00000003_polypolish,48249,48250,1
322,Agrobacterium tumefaciens,3,2,At32.1,tig00000003_polypolish,67838,67839,1
323,Agrobacterium tumefaciens,3,2,At32.1,tig00000003_polypolish,113093,113094,1
324,Agrobacterium tumefaciens,3,2,At32.1,tig00000003_polypolish,117471,117472,1
325,Agrobacterium tumefaciens,3,2,At32.1,tig00000003_polypolish,122499,122500,1
326,Agrobacterium tumefaciens,3,2,At32.1,tig00000003_polypolish,135277,135278,1
327,Agrobacterium tumefaciens,3,2,At32.1,tig00000003_polypolish,135880,135881,1
328,Agrobacterium tumefaciens,3,2,At32.1,tig00000003_polypolish,165730,165731,1
329,Agrobacterium tumefaciens,3,2,At32.1,tig00000003_polypolish,211881,211882,1
330,Agrobacterium tumefaciens,3,2,At32.1,tig00000003_polypolish,212745,213991,1246
331,Agrobacterium tumefaciens,3,2,At32.1,tig00000004_polypolish,0,1575,1575
332,Agrobacterium tumefaciens,3,2,At32.1,tig00000004_polypolish,2373,2374,1
333,Agrobacterium tumefaciens,3,2,At32.1,tig00000004_polypolish,2491,2492,1
334,Agrobacterium tumefaciens,3,2,At32.1,tig00000004_polypolish,2636,2637,1
335,Agrobacterium tumefaciens,3,2,At32.1,tig00000004_polypolish,3096,3097,1
336,Agrobacterium tumefaciens,3,2,At32.1,tig00000004_polypolish,3287,3288,1
337,Agrobacterium tumefaciens,3,2,At32.1,tig00000004_polypolish,8755,8756,1
338,Agrobacterium tumefaciens,3,2,At32.1,tig00000004_polypolish,9066,9067,1
339,Agrobacterium tumefaciens,3,2,At32.1,tig00000004_polypolish,10938,10939,1
340,Agrobacterium tumefaciens,3,2,At32.1,tig00000004_polypolish,19185,19186,1
341,Agrobacterium tumefaciens,3,2,At32.1,tig00000004_polypolish,31469,31470,1
342,Agrobacterium tumefaciens,3,2,At32.1,tig00000004_polypolish,44959,44960,1
343,Agrobacterium tumefaciens,3,2,At32.1,tig00000004_polypolish,45255,45256,1
344,Agrobacterium tumefaciens,3,2,At32.1,tig00000004_polypolish,59413,59414,1
345,Agrobacterium tumefaciens,3,2,At32.1,tig00000004_polypolish,62623,62624,1
346,Agrobacterium tumefaciens,3,2,At32.1,tig00000004_polypolish,68082,68083,1
347,Agrobacterium tumefaciens,3,2,At32.1,tig00000004_polypolish,73333,73334,1
348,Agrobacterium tumefaciens,3,2,At32.1,tig00000004_polypolish,79224,79225,1
349,Agrobacterium tumefaciens,3,2,At32.1,tig00000004_polypolish,80332,80333,1
350,Agrobacterium tumefaciens,3,2,At32.1,tig00000004_polypolish,86815,86816,1
351,Agrobacterium tumefaciens,3,2,At32.1,tig00000004_polypolish,93686,93687,1
352,Agrobacterium tumefaciens,3,2,At32.1,tig00000004_polypolish,123354,123801,447
353,Agrobacterium tumefaciens,3,2,At32.1,tig00000004_polypolish,161586,161587,1
354,Agrobacterium tumefaciens,3,2,At32.1,tig00000004_polypolish,161614,161615,1
355,Agrobacterium tumefaciens,3,2,At32.1,tig00000004_polypolish,162319,162320,1
356,Agrobacterium tumefaciens,3,2,At32.1,tig00000004_polypolish,162730,162731,1
357,Agrobacterium tumefaciens,3,2,At32.1,tig00000004_polypolish,162882,162883,1
358,Agrobacterium tumefaciens,3,2,At32.1,tig00000004_polypolish,163569,163570,1
359,Agrobacterium tumefaciens,3,2,At32.1,tig00000004_polypolish,163659,163660,1
360,Agrobacterium tumefaciens,3,2,At32.1,tig00000004_polypolish,167805,167806,1
361,Agrobacterium tumefaciens,3,2,At32.1,tig00000004_polypolish,169155,169156,1
362,Agrobacterium tumefaciens,3,2,At32.1,tig00000004_polypolish,169412,169413,1
363,Agrobacterium tumefaciens,3,2,At32.1,tig00000004_polypolish,218562,218563,1
364,Agrobacterium tumefaciens,3,2,At32.1,tig00000004_polypolish,221067,221068,1
365,Agrobacterium tumefaciens,3,2,At32.1,tig00000004_polypolish,223454,223455,1
366,Agrobacterium tumefaciens,3,2,At32.1,tig00000004_polypolish,224026,224027,1
367,Agrobacterium tumefaciens,3,2,At32.1,tig00000004_polypolish,224191,224192,1
368,Agrobacterium tumefaciens,3,2,At32.1,tig00000004_polypolish,225051,225052,1
369,Agrobacterium tumefaciens,3,2,At32.1,tig00000004_polypolish,225132,225134,2
370,Agrobacterium tumefaciens,3,2,At32.1,tig00000004_polypolish,225240,225241,1
371,Agrobacterium tumefaciens,3,2,At32.1,tig00000004_polypolish,225303,225304,1
372,Agrobacterium tumefaciens,3,2,At32.1,tig00000004_polypolish,225324,225325,1
373,Agrobacterium tumefaciens,3,2,At32.1,tig00000004_polypolish,225499,225500,1
374,Agrobacterium tumefaciens,3,2,At32.1,tig00000004_polypolish,225764,225765,1
375,Agrobacterium tumefaciens,3,2,At32.1,tig00000004_polypolish,225986,229503,3517
376,Agrobacterium tumefaciens,3,2,At32.1,tig00000005_polypolish,0,31114,31114
377,Agrobacterium tumefaciens,3,3,At33.1,tig00000001_polypolish,1,882,881
378,Agrobacterium tumefaciens,3,3,At33.1,tig00000001_polypolish,1191,1192,1
379,Agrobacterium tumefaciens,3,3,At33.1,tig00000001_polypolish,1610,1611,1
380,Agrobacterium tumefaciens,3,3,At33.1,tig00000001_polypolish,2410,2412,2
381,Agrobacterium tumefaciens,3,3,At33.1,tig00000001_polypolish,201820,201821,1
382,Agrobacterium tumefaciens,3,3,At33.1,tig00000001_polypolish,1172377,1172395,18
383,Agrobacterium tumefaciens,3,3,At33.1,tig00000001_polypolish,1197892,1199993,2101
384,Agrobacterium tumefaciens,3,3,At33.1,tig00000001_polypolish,2994854,2994855,1
385,Agrobacterium tumefaciens,3,3,At33.1,tig00000001_polypolish,2995308,2995309,1
386,Agrobacterium tumefaciens,3,3,At33.1,tig00000001_polypolish,2995742,2995744,2
387,Agrobacterium tumefaciens,3,3,At33.1,tig00000001_polypolish,2995748,2995749,1
388,Agrobacterium tumefaciens,3,3,At33.1,tig00000001_polypolish,2996098,2996099,1
389,Agrobacterium tumefaciens,3,3,At33.1,tig00000001_polypolish,2996109,2996110,1
390,Agrobacterium tumefaciens,3,3,At33.1,tig00000001_polypolish,2996576,2996577,1
391,Agrobacterium tumefaciens,3,3,At33.1,tig00000001_polypolish,2996891,2996892,1
392,Agrobacterium tumefaciens,3,3,At33.1,tig00000001_polypolish,2997087,2997088,1
393,Agrobacterium tumefaciens,3,3,At33.1,tig00000001_polypolish,2997145,2999962,2817
394,Agrobacterium tumefaciens,3,3,At33.1,tig00000003_polypolish,0,1485,1485
395,Agrobacterium tumefaciens,3,3,At33.1,tig00000003_polypolish,1873,1874,1
396,Agrobacterium tumefaciens,3,3,At33.1,tig00000003_polypolish,5482,5483,1
397,Agrobacterium tumefaciens,3,3,At33.1,tig00000003_polypolish,6034,6036,2
398,Agrobacterium tumefaciens,3,3,At33.1,tig00000003_polypolish,7865,7866,1
399,Agrobacterium tumefaciens,3,3,At33.1,tig00000003_polypolish,8577,8578,1
400,Agrobacterium tumefaciens,3,3,At33.1,tig00000003_polypolish,9430,11979,2549
401,Agrobacterium tumefaciens,3,3,At33.1,tig00000003_polypolish,14737,14738,1
402,Agrobacterium tumefaciens,3,3,At33.1,tig00000003_polypolish,14743,14744,1
403,Agrobacterium tumefaciens,3,3,At33.1,tig00000003_polypolish,16242,16243,1
404,Agrobacterium tumefaciens,3,3,At33.1,tig00000003_polypolish,20398,20399,1
405,Agrobacterium tumefaciens,3,3,At33.1,tig00000003_polypolish,48249,48250,1
406,Agrobacterium tumefaciens,3,3,At33.1,tig00000003_polypolish,59231,59232,1
407,Agrobacterium tumefaciens,3,3,At33.1,tig00000003_polypolish,63497,63498,1
408,Agrobacterium tumefaciens,3,3,At33.1,tig00000003_polypolish,64241,64242,1
409,Agrobacterium tumefaciens,3,3,At33.1,tig00000003_polypolish,147928,147929,1
410,Agrobacterium tumefaciens,3,3,At33.1,tig00000003_polypolish,175375,175376,1
411,Agrobacterium tumefaciens,3,3,At33.1,tig00000003_polypolish,175656,175657,1
412,Agrobacterium tumefaciens,3,3,At33.1,tig00000003_polypolish,176053,176054,1
413,Agrobacterium tumefaciens,3,3,At33.1,tig00000003_polypolish,177094,177095,1
414,Agrobacterium tumefaciens,3,3,At33.1,tig00000003_polypolish,177169,177170,1
415,Agrobacterium tumefaciens,3,3,At33.1,tig00000003_polypolish,177385,177386,1
416,Agrobacterium tumefaciens,3,3,At33.1,tig00000003_polypolish,177910,177911,1
417,Agrobacterium tumefaciens,3,3,At33.1,tig00000003_polypolish,178212,178213,1
418,Agrobacterium tumefaciens,3,3,At33.1,tig00000003_polypolish,180044,180045,1
419,Agrobacterium tumefaciens,3,3,At33.1,tig00000003_polypolish,180426,180427,1
420,Agrobacterium tumefaciens,3,3,At33.1,tig00000003_polypolish,181474,181475,1
421,Agrobacterium tumefaciens,3,3,At33.1,tig00000003_polypolish,181723,181724,1
422,Agrobacterium tumefaciens,3,3,At33.1,tig00000003_polypolish,181811,181812,1
423,Agrobacterium tumefaciens,3,3,At33.1,tig00000003_polypolish,181913,182263,350
424,Agrobacterium tumefaciens,3,3,At33.1,tig00000003_polypolish,183021,183022,1
425,Agrobacterium tumefaciens,3,3,At33.1,tig00000003_polypolish,183762,183763,1
426,Agrobacterium tumefaciens,3,3,At33.1,tig00000003_polypolish,196424,196425,1
427,Agrobacterium tumefaciens,3,3,At33.1,tig00000003_polypolish,199153,199154,1
428,Agrobacterium tumefaciens,3,3,At33.1,tig00000003_polypolish,199899,199900,1
429,Agrobacterium tumefaciens,3,3,At33.1,tig00000003_polypolish,205242,205246,4
430,Agrobacterium tumefaciens,3,3,At33.1,tig00000003_polypolish,205254,205255,1
431,Agrobacterium tumefaciens,3,3,At33.1,tig00000003_polypolish,208171,208172,1
432,Agrobacterium tumefaciens,3,3,At33.1,tig00000003_polypolish,208819,208820,1
433,Agrobacterium tumefaciens,3,3,At33.1,tig00000003_polypolish,208942,213991,5049
434,Agrobacterium tumefaciens,3,3,At33.1,tig00000004_polypolish,0,2641,2641
435,Agrobacterium tumefaciens,3,3,At33.1,tig00000004_polypolish,2694,2695,1
436,Agrobacterium tumefaciens,3,3,At33.1,tig00000004_polypolish,3682,3683,1
437,Agrobacterium tumefaciens,3,3,At33.1,tig00000004_polypolish,5259,5260,1
438,Agrobacterium tumefaciens,3,3,At33.1,tig00000004_polypolish,6482,6483,1
439,Agrobacterium tumefaciens,3,3,At33.1,tig00000004_polypolish,40366,40367,1
440,Agrobacterium tumefaciens,3,3,At33.1,tig00000004_polypolish,40656,40657,1
441,Agrobacterium tumefaciens,3,3,At33.1,tig00000004_polypolish,67636,67637,1
442,Agrobacterium tumefaciens,3,3,At33.1,tig00000004_polypolish,69114,69115,1
443,Agrobacterium tumefaciens,3,3,At33.1,tig00000004_polypolish,100408,100409,1
444,Agrobacterium tumefaciens,3,3,At33.1,tig00000004_polypolish,100424,100425,1
445,Agrobacterium tumefaciens,3,3,At33.1,tig00000004_polypolish,100768,100769,1
446,Agrobacterium tumefaciens,3,3,At33.1,tig00000004_polypolish,100778,100779,1
447,Agrobacterium tumefaciens,3,3,At33.1,tig00000004_polypolish,100864,100865,1
448,Agrobacterium tumefaciens,3,3,At33.1,tig00000004_polypolish,100896,102039,1143
449,Agrobacterium tumefaciens,3,3,At33.1,tig00000004_polypolish,102051,102052,1
450,Agrobacterium tumefaciens,3,3,At33.1,tig00000004_polypolish,102291,102292,1
451,Agrobacterium tumefaciens,3,3,At33.1,tig00000004_polypolish,102454,102455,1
452,Agrobacterium tumefaciens,3,3,At33.1,tig00000004_polypolish,102758,102759,1
453,Agrobacterium tumefaciens,3,3,At33.1,tig00000004_polypolish,103064,103065,1
454,Agrobacterium tumefaciens,3,3,At33.1,tig00000004_polypolish,103113,103114,1
455,Agrobacterium tumefaciens,3,3,At33.1,tig00000004_polypolish,103555,103556,1
456,Agrobacterium tumefaciens,3,3,At33.1,tig00000004_polypolish,104030,104031,1
457,Agrobacterium tumefaciens,3,3,At33.1,tig00000004_polypolish,104200,104201,1
458,Agrobacterium tumefaciens,3,3,At33.1,tig00000004_polypolish,105432,105433,1
459,Agrobacterium tumefaciens,3,3,At33.1,tig00000004_polypolish,105482,105483,1
460,Agrobacterium tumefaciens,3,3,At33.1,tig00000004_polypolish,105523,105524,1
461,Agrobacterium tumefaciens,3,3,At33.1,tig00000004_polypolish,105828,105829,1
462,Agrobacterium tumefaciens,3,3,At33.1,tig00000004_polypolish,105874,105875,1
463,Agrobacterium tumefaciens,3,3,At33.1,tig00000004_polypolish,105929,105930,1
464,Agrobacterium tumefaciens,3,3,At33.1,tig00000004_polypolish,105978,105979,1
465,Agrobacterium tumefaciens,3,3,At33.1,tig00000004_polypolish,106127,106128,1
466,Agrobacterium tumefaciens,3,3,At33.1,tig00000004_polypolish,106175,106176,1
467,Agrobacterium tumefaciens,3,3,At33.1,tig00000004_polypolish,106246,106247,1
468,Agrobacterium tumefaciens,3,3,At33.1,tig00000004_polypolish,106372,106373,1
469,Agrobacterium tumefaciens,3,3,At33.1,tig00000004_polypolish,106387,106388,1
470,Agrobacterium tumefaciens,3,3,At33.1,tig00000004_polypolish,106559,106560,1
471,Agrobacterium tumefaciens,3,3,At33.1,tig00000004_polypolish,106598,106599,1
472,Agrobacterium tumefaciens,3,3,At33.1,tig00000004_polypolish,107068,107069,1
473,Agrobacterium tumefaciens,3,3,At33.1,tig00000004_polypolish,107072,107073,1
474,Agrobacterium tumefaciens,3,3,At33.1,tig00000004_polypolish,107164,107165,1
475,Agrobacterium tumefaciens,3,3,At33.1,tig00000004_polypolish,107171,107173,2
476,Agrobacterium tumefaciens,3,3,At33.1,tig00000004_polypolish,107307,107308,1
477,Agrobacterium tumefaciens,3,3,At33.1,tig00000004_polypolish,110924,110925,1
478,Agrobacterium tumefaciens,3,3,At33.1,tig00000004_polypolish,115509,115510,1
479,Agrobacterium tumefaciens,3,3,At33.1,tig00000004_polypolish,118088,118089,1
480,Agrobacterium tumefaciens,3,3,At33.1,tig00000004_polypolish,121320,121321,1
481,Agrobacterium tumefaciens,3,3,At33.1,tig00000004_polypolish,128269,128270,1
482,Agrobacterium tumefaciens,3,3,At33.1,tig00000004_polypolish,144574,144575,1
483,Agrobacterium tumefaciens,3,3,At33.1,tig00000004_polypolish,187858,187859,1
484,Agrobacterium tumefaciens,3,3,At33.1,tig00000004_polypolish,194897,194898,1
485,Agrobacterium tumefaciens,3,3,At33.1,tig00000004_polypolish,203333,203334,1
486,Agrobacterium tumefaciens,3,3,At33.1,tig00000004_polypolish,204160,204161,1
487,Agrobacterium tumefaciens,3,3,At33.1,tig00000004_polypolish,216391,216392,1
488,Agrobacterium tumefaciens,3,3,At33.1,tig00000004_polypolish,224760,224761,1
489,Agrobacterium tumefaciens,3,3,At33.1,tig00000004_polypolish,225248,225249,1
490,Agrobacterium tumefaciens,3,3,At33.1,tig00000004_polypolish,226437,226438,1
491,Agrobacterium tumefaciens,3,3,At33.1,tig00000004_polypolish,226786,226787,1
492,Agrobacterium tumefaciens,3,3,At33.1,tig00000004_polypolish,227373,227374,1
493,Agrobacterium tumefaciens,3,3,At33.1,tig00000004_polypolish,227401,229503,2102
494,Agrobacterium tumefaciens,3,3,At33.1,tig00000005_polypolish,0,31114,31114
495,Agrobacterium tumefaciens,3,4,At34.1,tig00000001_polypolish,1,118,117
496,Agrobacterium tumefaciens,3,4,At34.1,tig00000001_polypolish,1163,1164,1
497,Agrobacterium tumefaciens,3,4,At34.1,tig00000001_polypolish,1590,1591,1
498,Agrobacterium tumefaciens,3,4,At34.1,tig00000001_polypolish,1649,1650,1
499,Agrobacterium tumefaciens,3,4,At34.1,tig00000001_polypolish,2053,2054,1
500,Agrobacterium tumefaciens,3,4,At34.1,tig00000001_polypolish,2104,2105,1
501,Agrobacterium tumefaciens,3,4,At34.1,tig00000001_polypolish,2356,2357,1
502,Agrobacterium tumefaciens,3,4,At34.1,tig00000001_polypolish,109570,109571,1
503,Agrobacterium tumefaciens,3,4,At34.1,tig00000001_polypolish,809581,809582,1
504,Agrobacterium tumefaciens,3,4,At34.1,tig00000001_polypolish,818205,818206,1
505,Agrobacterium tumefaciens,3,4,At34.1,tig00000001_polypolish,963453,963454,1
506,Agrobacterium tumefaciens,3,4,At34.1,tig00000001_polypolish,1409472,1409473,1
507,Agrobacterium tumefaciens,3,4,At34.1,tig00000001_polypolish,2995401,2995403,2
508,Agrobacterium tumefaciens,3,4,At34.1,tig00000001_polypolish,2997467,2999962,2495
509,Agrobacterium tumefaciens,3,4,At34.1,tig00000003_polypolish,0,1842,1842
510,Agrobacterium tumefaciens,3,4,At34.1,tig00000003_polypolish,2245,2246,1
511,Agrobacterium tumefaciens,3,4,At34.1,tig00000003_polypolish,2282,2283,1
512,Agrobacterium tumefaciens,3,4,At34.1,tig00000003_polypolish,2553,2554,1
513,Agrobacterium tumefaciens,3,4,At34.1,tig00000003_polypolish,2917,2919,2
514,Agrobacterium tumefaciens,3,4,At34.1,tig00000003_polypolish,3563,3564,1
515,Agrobacterium tumefaciens,3,4,At34.1,tig00000003_polypolish,3606,3607,1
516,Agrobacterium tumefaciens,3,4,At34.1,tig00000003_polypolish,4715,4716,1
517,Agrobacterium tumefaciens,3,4,At34.1,tig00000003_polypolish,6757,6758,1
518,Agrobacterium tumefaciens,3,4,At34.1,tig00000003_polypolish,7741,7742,1
519,Agrobacterium tumefaciens,3,4,At34.1,tig00000003_polypolish,8021,8022,1
520,Agrobacterium tumefaciens,3,4,At34.1,tig00000003_polypolish,11521,11522,1
521,Agrobacterium tumefaciens,3,4,At34.1,tig00000003_polypolish,19546,19547,1
522,Agrobacterium tumefaciens,3,4,At34.1,tig00000003_polypolish,58777,58778,1
523,Agrobacterium tumefaciens,3,4,At34.1,tig00000003_polypolish,59554,59555,1
524,Agrobacterium tumefaciens,3,4,At34.1,tig00000003_polypolish,59652,59653,1
525,Agrobacterium tumefaciens,3,4,At34.1,tig00000003_polypolish,61880,61881,1
526,Agrobacterium tumefaciens,3,4,At34.1,tig00000003_polypolish,63230,63231,1
527,Agrobacterium tumefaciens,3,4,At34.1,tig00000003_polypolish,64932,64933,1
528,Agrobacterium tumefaciens,3,4,At34.1,tig00000003_polypolish,64976,64977,1
529,Agrobacterium tumefaciens,3,4,At34.1,tig00000003_polypolish,66966,66967,1
530,Agrobacterium tumefaciens,3,4,At34.1,tig00000003_polypolish,68066,68067,1
531,Agrobacterium tumefaciens,3,4,At34.1,tig00000003_polypolish,68697,68698,1
532,Agrobacterium tumefaciens,3,4,At34.1,tig00000003_polypolish,109882,109883,1
533,Agrobacterium tumefaciens,3,4,At34.1,tig00000003_polypolish,116383,116384,1
534,Agrobacterium tumefaciens,3,4,At34.1,tig00000003_polypolish,121190,121191,1
535,Agrobacterium tumefaciens,3,4,At34.1,tig00000003_polypolish,121326,121327,1
536,Agrobacterium tumefaciens,3,4,At34.1,tig00000003_polypolish,122472,122473,1
537,Agrobacterium tumefaciens,3,4,At34.1,tig00000003_polypolish,134735,134736,1
538,Agrobacterium tumefaciens,3,4,At34.1,tig00000003_polypolish,137210,137211,1
539,Agrobacterium tumefaciens,3,4,At34.1,tig00000003_polypolish,146706,146707,1
540,Agrobacterium tumefaciens,3,4,At34.1,tig00000003_polypolish,170760,170761,1
541,Agrobacterium tumefaciens,3,4,At34.1,tig00000003_polypolish,175723,175724,1
542,Agrobacterium tumefaciens,3,4,At34.1,tig00000003_polypolish,177154,177155,1
543,Agrobacterium tumefaciens,3,4,At34.1,tig00000003_polypolish,178920,178921,1
544,Agrobacterium tumefaciens,3,4,At34.1,tig00000003_polypolish,184987,184988,1
545,Agrobacterium tumefaciens,3,4,At34.1,tig00000003_polypolish,196246,196247,1
546,Agrobacterium tumefaciens,3,4,At34.1,tig00000003_polypolish,196811,196812,1
547,Agrobacterium tumefaciens,3,4,At34.1,tig00000003_polypolish,197933,197934,1
548,Agrobacterium tumefaciens,3,4,At34.1,tig00000003_polypolish,203388,213991,10603
549,Agrobacterium tumefaciens,3,4,At34.1,tig00000004_polypolish,0,1490,1490
550,Agrobacterium tumefaciens,3,4,At34.1,tig00000004_polypolish,1528,1529,1
551,Agrobacterium tumefaciens,3,4,At34.1,tig00000004_polypolish,1663,1664,1
552,Agrobacterium tumefaciens,3,4,At34.1,tig00000004_polypolish,1717,1718,1
553,Agrobacterium tumefaciens,3,4,At34.1,tig00000004_polypolish,1844,1845,1
554,Agrobacterium tumefaciens,3,4,At34.1,tig00000004_polypolish,2772,2773,1
555,Agrobacterium tumefaciens,3,4,At34.1,tig00000004_polypolish,3620,3621,1
556,Agrobacterium tumefaciens,3,4,At34.1,tig00000004_polypolish,8662,8663,1
557,Agrobacterium tumefaciens,3,4,At34.1,tig00000004_polypolish,10477,10478,1
558,Agrobacterium tumefaciens,3,4,At34.1,tig00000004_polypolish,13907,13908,1
559,Agrobacterium tumefaciens,3,4,At34.1,tig00000004_polypolish,36175,36176,1
560,Agrobacterium tumefaciens,3,4,At34.1,tig00000004_polypolish,89906,89907,1
561,Agrobacterium tumefaciens,3,4,At34.1,tig00000004_polypolish,98280,98281,1
562,Agrobacterium tumefaciens,3,4,At34.1,tig00000004_polypolish,150752,150753,1
563,Agrobacterium tumefaciens,3,4,At34.1,tig00000004_polypolish,191264,191265,1
564,Agrobacterium tumefaciens,3,4,At34.1,tig00000004_polypolish,192555,192556,1
565,Agrobacterium tumefaciens,3,4,At34.1,tig00000004_polypolish,213998,213999,1
566,Agrobacterium tumefaciens,3,4,At34.1,tig00000004_polypolish,215219,215220,1
567,Agrobacterium tumefaciens,3,4,At34.1,tig00000004_polypolish,218271,218272,1
568,Agrobacterium tumefaciens,3,4,At34.1,tig00000004_polypolish,218312,218313,1
569,Agrobacterium tumefaciens,3,4,At34.1,tig00000004_polypolish,218913,218914,1
570,Agrobacterium tumefaciens,3,4,At34.1,tig00000004_polypolish,222173,222174,1
571,Agrobacterium tumefaciens,3,4,At34.1,tig00000004_polypolish,222747,222748,1
572,Agrobacterium tumefaciens,3,4,At34.1,tig00000004_polypolish,223357,223358,1
573,Agrobacterium tumefaciens,3,4,At34.1,tig00000004_polypolish,223454,223455,1
574,Agrobacterium tumefaciens,3,4,At34.1,tig00000004_polypolish,223561,223562,1
575,Agrobacterium tumefaciens,3,4,At34.1,tig00000004_polypolish,224118,224119,1
576,Agrobacterium tumefaciens,3,4,At34.1,tig00000004_polypolish,224687,229503,4816
577,Agrobacterium tumefaciens,3,4,At34.1,tig00000005_polypolish,133,134,1
578,Agrobacterium tumefaciens,3,4,At34.1,tig00000005_polypolish,153,154,1
579,Agrobacterium tumefaciens,3,4,At34.1,tig00000005_polypolish,308,309,1
580,Agrobacterium tumefaciens,3,4,At34.1,tig00000005_polypolish,1288,1289,1
581,Agrobacterium tumefaciens,3,4,At34.1,tig00000005_polypolish,1729,1730,1
582,Agrobacterium tumefaciens,3,4,At34.1,tig00000005_polypolish,1850,1851,1
583,Agrobacterium tumefaciens,3,4,At34.1,tig00000005_polypolish,1861,1862,1
584,Agrobacterium tumefaciens,3,4,At34.1,tig00000005_polypolish,2173,2174,1
585,Agrobacterium tumefaciens,3,4,At34.1,tig00000005_polypolish,2495,2496,1
586,Agrobacterium tumefaciens,3,4,At34.1,tig00000005_polypolish,3103,3104,1
587,Agrobacterium tumefaciens,3,4,At34.1,tig00000005_polypolish,4459,4460,1
588,Agrobacterium tumefaciens,3,4,At34.1,tig00000005_polypolish,4553,4554,1
589,Agrobacterium tumefaciens,3,4,At34.1,tig00000005_polypolish,5140,5141,1
590,Agrobacterium tumefaciens,3,4,At34.1,tig00000005_polypolish,5210,5211,1
591,Agrobacterium tumefaciens,3,4,At34.1,tig00000005_polypolish,7243,7244,1
592,Agrobacterium tumefaciens,3,4,At34.1,tig00000005_polypolish,7886,7887,1
593,Agrobacterium tumefaciens,3,4,At34.1,tig00000005_polypolish,8106,8107,1
594,Agrobacterium tumefaciens,3,4,At34.1,tig00000005_polypolish,8807,8808,1
595,Agrobacterium tumefaciens,3,4,At34.1,tig00000005_polypolish,9253,9254,1
596,Agrobacterium tumefaciens,3,4,At34.1,tig00000005_polypolish,10055,10056,1
597,Agrobacterium tumefaciens,3,4,At34.1,tig00000005_polypolish,10484,10485,1
598,Agrobacterium tumefaciens,3,4,At34.1,tig00000005_polypolish,11323,11324,1
599,Agrobacterium tumefaciens,3,4,At34.1,tig00000005_polypolish,11775,11776,1
600,Agrobacterium tumefaciens,3,4,At34.1,tig00000005_polypolish,11918,11919,1
601,Agrobacterium tumefaciens,3,4,At34.1,tig00000005_polypolish,12765,12766,1
602,Agrobacterium tumefaciens,3,4,At34.1,tig00000005_polypolish,13012,13013,1
603,Agrobacterium tumefaciens,3,4,At34.1,tig00000005_polypolish,14171,14172,1
604,Agrobacterium tumefaciens,3,4,At34.1,tig00000005_polypolish,14923,14924,1
605,Agrobacterium tumefaciens,3,4,At34.1,tig00000005_polypolish,15809,15810,1
606,Agrobacterium tumefaciens,3,4,At34.1,tig00000005_polypolish,15953,15954,1
607,Agrobacterium tumefaciens,3,4,At34.1,tig00000005_polypolish,18104,22889,4785
608,Agrobacterium tumefaciens,3,4,At34.1,tig00000005_polypolish,22909,22910,1
609,Agrobacterium tumefaciens,3,4,At34.1,tig00000005_polypolish,22940,22941,1
610,Agrobacterium tumefaciens,3,4,At34.1,tig00000005_polypolish,23037,23039,2
611,Agrobacterium tumefaciens,3,4,At34.1,tig00000005_polypolish,23058,23059,1
612,Agrobacterium tumefaciens,3,4,At34.1,tig00000005_polypolish,23137,23138,1
613,Agrobacterium tumefaciens,3,4,At34.1,tig00000005_polypolish,23180,23181,1
614,Agrobacterium tumefaciens,3,4,At34.1,tig00000005_polypolish,23292,23293,1
615,Agrobacterium tumefaciens,3,4,At34.1,tig00000005_polypolish,23438,23439,1
616,Agrobacterium tumefaciens,3,4,At34.1,tig00000005_polypolish,23656,23657,1
617,Agrobacterium tumefaciens,3,4,At34.1,tig00000005_polypolish,23671,23672,1
618,Agrobacterium tumefaciens,3,4,At34.1,tig00000005_polypolish,23810,23811,1
619,Agrobacterium tumefaciens,3,4,At34.1,tig00000005_polypolish,23819,23820,1
620,Agrobacterium tumefaciens,3,4,At34.1,tig00000005_polypolish,24004,24005,1
621,Agrobacterium tumefaciens,3,4,At34.1,tig00000005_polypolish,24407,24408,1
622,Agrobacterium tumefaciens,3,4,At34.1,tig00000005_polypolish,24529,24530,1
623,Agrobacterium tumefaciens,3,4,At34.1,tig00000005_polypolish,24712,24713,1
624,Agrobacterium tumefaciens,3,4,At34.1,tig00000005_polypolish,24898,24899,1
625,Agrobacterium tumefaciens,3,4,At34.1,tig00000005_polypolish,25289,25290,1
626,Agrobacterium tumefaciens,3,4,At34.1,tig00000005_polypolish,25323,25325,2
627,Agrobacterium tumefaciens,3,4,At34.1,tig00000005_polypolish,25475,25476,1
628,Agrobacterium tumefaciens,3,4,At34.1,tig00000005_polypolish,25715,25716,1
629,Agrobacterium tumefaciens,3,4,At34.1,tig00000005_polypolish,26063,26064,1
630,Agrobacterium tumefaciens,3,4,At34.1,tig00000005_polypolish,26111,26112,1
631,Agrobacterium tumefaciens,3,4,At34.1,tig00000005_polypolish,26202,26204,2
632,Agrobacterium tumefaciens,3,4,At34.1,tig00000005_polypolish,26213,26214,1
633,Agrobacterium tumefaciens,3,4,At34.1,tig00000005_polypolish,26312,26313,1
634,Agrobacterium tumefaciens,3,4,At34.1,tig00000005_polypolish,26318,26319,1
635,Agrobacterium tumefaciens,3,4,At34.1,tig00000005_polypolish,26341,26342,1
636,Agrobacterium tumefaciens,3,4,At34.1,tig00000005_polypolish,26419,26420,1
637,Agrobacterium tumefaciens,3,4,At34.1,tig00000005_polypolish,26427,26428,1
638,Agrobacterium tumefaciens,3,4,At34.1,tig00000005_polypolish,26430,26431,1
639,Agrobacterium tumefaciens,3,4,At34.1,tig00000005_polypolish,26436,26437,1
640,Agrobacterium tumefaciens,3,4,At34.1,tig00000005_polypolish,26707,26708,1
641,Agrobacterium tumefaciens,3,4,At34.1,tig00000005_polypolish,26934,26935,1
642,Agrobacterium tumefaciens,3,4,At34.1,tig00000005_polypolish,26947,26948,1
643,Agrobacterium tumefaciens,3,4,At34.1,tig00000005_polypolish,26990,26992,2
644,Agrobacterium tumefaciens,3,4,At34.1,tig00000005_polypolish,27156,27157,1
645,Agrobacterium tumefaciens,3,4,At34.1,tig00000005_polypolish,27181,27182,1
646,Agrobacterium tumefaciens,3,4,At34.1,tig00000005_polypolish,27184,27185,1
647,Agrobacterium tumefaciens,3,4,At34.1,tig00000005_polypolish,27191,27192,1
648,Agrobacterium tumefaciens,3,4,At34.1,tig00000005_polypolish,27247,27248,1
649,Agrobacterium tumefaciens,3,4,At34.1,tig00000005_polypolish,27257,27258,1
650,Agrobacterium tumefaciens,3,4,At34.1,tig00000005_polypolish,27269,27270,1
651,Agrobacterium tumefaciens,3,4,At34.1,tig00000005_polypolish,27657,27658,1
652,Agrobacterium tumefaciens,3,4,At34.1,tig00000005_polypolish,27703,27704,1
653,Agrobacterium tumefaciens,3,4,At34.1,tig00000005_polypolish,27843,27844,1
654,Agrobacterium tumefaciens,3,4,At34.1,tig00000005_polypolish,27868,27870,2
655,Agrobacterium tumefaciens,3,4,At34.1,tig00000005_polypolish,27872,27873,1
656,Agrobacterium tumefaciens,3,4,At34.1,tig00000005_polypolish,27942,27944,2
657,Agrobacterium tumefaciens,3,4,At34.1,tig00000005_polypolish,28154,28155,1
658,Agrobacterium tumefaciens,3,4,At34.1,tig00000005_polypolish,28227,28228,1
659,Agrobacterium tumefaciens,3,4,At34.1,tig00000005_polypolish,28470,28471,1
660,Agrobacterium tumefaciens,3,4,At34.1,tig00000005_polypolish,28546,28547,1
661,Agrobacterium tumefaciens,3,4,At34.1,tig00000005_polypolish,28549,28550,1
662,Agrobacterium tumefaciens,3,4,At34.1,tig00000005_polypolish,29058,29059,1
663,Agrobacterium tumefaciens,3,4,At34.1,tig00000005_polypolish,29157,29159,2
664,Agrobacterium tumefaciens,3,4,At34.1,tig00000005_polypolish,29382,29383,1
665,Agrobacterium tumefaciens,3,4,At34.1,tig00000005_polypolish,29402,29403,1
666,Agrobacterium tumefaciens,3,4,At34.1,tig00000005_polypolish,29557,29558,1
667,Agrobacterium tumefaciens,3,4,At34.1,tig00000005_polypolish,29561,29563,2
668,Agrobacterium tumefaciens,3,4,At34.1,tig00000005_polypolish,29599,29600,1
669,Agrobacterium tumefaciens,3,4,At34.1,tig00000005_polypolish,29672,29673,1
670,Agrobacterium tumefaciens,3,4,At34.1,tig00000005_polypolish,29800,29801,1
671,Agrobacterium tumefaciens,3,4,At34.1,tig00000005_polypolish,29994,29995,1
672,Agrobacterium tumefaciens,3,4,At34.1,tig00000005_polypolish,30131,30132,1
673,Agrobacterium tumefaciens,3,4,At34.1,tig00000005_polypolish,30237,30238,1
674,Agrobacterium tumefaciens,3,4,At34.1,tig00000005_polypolish,30537,30538,1
675,Agrobacterium tumefaciens,3,4,At34.1,tig00000005_polypolish,30891,30892,1
676,Agrobacterium tumefaciens,3,4,At34.1,tig00000005_polypolish,30975,30976,1
677,Agrobacterium tumefaciens,3,4,At34.1,tig00000005_polypolish,30978,30979,1
678,Agrobacterium tumefaciens,3,4,At34.1,tig00000005_polypolish,31095,31096,1
679,Agrobacterium tumefaciens,3,4,At34.1,tig00000005_polypolish,31108,31114,6
680,Agrobacterium tumefaciens,3,5,At35.1,tig00000001_polypolish,1,848,847
681,Agrobacterium tumefaciens,3,5,At35.1,tig00000001_polypolish,4200,4201,1
682,Agrobacterium tumefaciens,3,5,At35.1,tig00000001_polypolish,514182,514183,1
683,Agrobacterium tumefaciens,3,5,At35.1,tig00000001_polypolish,514970,514971,1
684,Agrobacterium tumefaciens,3,5,At35.1,tig00000001_polypolish,517054,517055,1
685,Agrobacterium tumefaciens,3,5,At35.1,tig00000001_polypolish,604889,604890,1
686,Agrobacterium tumefaciens,3,5,At35.1,tig00000001_polypolish,689411,689412,1
687,Agrobacterium tumefaciens,3,5,At35.1,tig00000001_polypolish,1628127,1628134,7
688,Agrobacterium tumefaciens,3,5,At35.1,tig00000001_polypolish,2530350,2530351,1
689,Agrobacterium tumefaciens,3,5,At35.1,tig00000001_polypolish,2996898,2996899,1
690,Agrobacterium tumefaciens,3,5,At35.1,tig00000001_polypolish,2997356,2999962,2606
691,Agrobacterium tumefaciens,3,5,At35.1,tig00000003_polypolish,0,993,993
692,Agrobacterium tumefaciens,3,5,At35.1,tig00000003_polypolish,1897,1898,1
693,Agrobacterium tumefaciens,3,5,At35.1,tig00000003_polypolish,1911,1912,1
694,Agrobacterium tumefaciens,3,5,At35.1,tig00000003_polypolish,4182,4183,1
695,Agrobacterium tumefaciens,3,5,At35.1,tig00000003_polypolish,38133,38134,1
696,Agrobacterium tumefaciens,3,5,At35.1,tig00000003_polypolish,210845,210846,1
697,Agrobacterium tumefaciens,3,5,At35.1,tig00000003_polypolish,210871,213991,3120
698,Agrobacterium tumefaciens,3,5,At35.1,tig00000004_polypolish,0,2897,2897
699,Agrobacterium tumefaciens,3,5,At35.1,tig00000004_polypolish,2915,2916,1
700,Agrobacterium tumefaciens,3,5,At35.1,tig00000004_polypolish,2935,2936,1
701,Agrobacterium tumefaciens,3,5,At35.1,tig00000004_polypolish,2950,2951,1
702,Agrobacterium tumefaciens,3,5,At35.1,tig00000004_polypolish,2989,2990,1
703,Agrobacterium tumefaciens,3,5,At35.1,tig00000004_polypolish,3067,3068,1
704,Agrobacterium tumefaciens,3,5,At35.1,tig00000004_polypolish,3233,3234,1
705,Agrobacterium tumefaciens,3,5,At35.1,tig00000004_polypolish,3287,3288,1
706,Agrobacterium tumefaciens,3,5,At35.1,tig00000004_polypolish,3355,3356,1
707,Agrobacterium tumefaciens,3,5,At35.1,tig00000004_polypolish,3364,3365,1
708,Agrobacterium tumefaciens,3,5,At35.1,tig00000004_polypolish,3380,3381,1
709,Agrobacterium tumefaciens,3,5,At35.1,tig00000004_polypolish,3464,3466,2
710,Agrobacterium tumefaciens,3,5,At35.1,tig00000004_polypolish,3470,3471,1
711,Agrobacterium tumefaciens,3,5,At35.1,tig00000004_polypolish,3673,3674,1
712,Agrobacterium tumefaciens,3,5,At35.1,tig00000004_polypolish,3682,3683,1
713,Agrobacterium tumefaciens,3,5,At35.1,tig00000004_polypolish,3696,3698,2
714,Agrobacterium tumefaciens,3,5,At35.1,tig00000004_polypolish,3802,3803,1
715,Agrobacterium tumefaciens,3,5,At35.1,tig00000004_polypolish,3868,3869,1
716,Agrobacterium tumefaciens,3,5,At35.1,tig00000004_polypolish,3980,3981,1
717,Agrobacterium tumefaciens,3,5,At35.1,tig00000004_polypolish,4150,4151,1
718,Agrobacterium tumefaciens,3,5,At35.1,tig00000004_polypolish,4161,4162,1
719,Agrobacterium tumefaciens,3,5,At35.1,tig00000004_polypolish,4207,4208,1
720,Agrobacterium tumefaciens,3,5,At35.1,tig00000004_polypolish,4438,4439,1
721,Agrobacterium tumefaciens,3,5,At35.1,tig00000004_polypolish,4565,4568,3
722,Agrobacterium tumefaciens,3,5,At35.1,tig00000004_polypolish,4698,4700,2
723,Agrobacterium tumefaciens,3,5,At35.1,tig00000004_polypolish,4703,4704,1
724,Agrobacterium tumefaciens,3,5,At35.1,tig00000004_polypolish,4845,4846,1
725,Agrobacterium tumefaciens,3,5,At35.1,tig00000004_polypolish,4904,4905,1
726,Agrobacterium tumefaciens,3,5,At35.1,tig00000004_polypolish,5033,5034,1
727,Agrobacterium tumefaciens,3,5,At35.1,tig00000004_polypolish,5061,5062,1
728,Agrobacterium tumefaciens,3,5,At35.1,tig00000004_polypolish,5065,5066,1
729,Agrobacterium tumefaciens,3,5,At35.1,tig00000004_polypolish,5123,5124,1
730,Agrobacterium tumefaciens,3,5,At35.1,tig00000004_polypolish,5163,5165,2
731,Agrobacterium tumefaciens,3,5,At35.1,tig00000004_polypolish,5230,5231,1
732,Agrobacterium tumefaciens,3,5,At35.1,tig00000004_polypolish,5255,5256,1
733,Agrobacterium tumefaciens,3,5,At35.1,tig00000004_polypolish,5658,5659,1
734,Agrobacterium tumefaciens,3,5,At35.1,tig00000004_polypolish,5802,5804,2
735,Agrobacterium tumefaciens,3,5,At35.1,tig00000004_polypolish,5893,5895,2
736,Agrobacterium tumefaciens,3,5,At35.1,tig00000004_polypolish,6076,6077,1
737,Agrobacterium tumefaciens,3,5,At35.1,tig00000004_polypolish,6138,6139,1
738,Agrobacterium tumefaciens,3,5,At35.1,tig00000004_polypolish,6875,6876,1
739,Agrobacterium tumefaciens,3,5,At35.1,tig00000004_polypolish,6929,6930,1
740,Agrobacterium tumefaciens,3,5,At35.1,tig00000004_polypolish,7121,7122,1
741,Agrobacterium tumefaciens,3,5,At35.1,tig00000004_polypolish,7125,7126,1
742,Agrobacterium tumefaciens,3,5,At35.1,tig00000004_polypolish,8383,8384,1
743,Agrobacterium tumefaciens,3,5,At35.1,tig00000004_polypolish,10202,10203,1
744,Agrobacterium tumefaciens,3,5,At35.1,tig00000004_polypolish,15174,15175,1
745,Agrobacterium tumefaciens,3,5,At35.1,tig00000004_polypolish,15365,15367,2
746,Agrobacterium tumefaciens,3,5,At35.1,tig00000004_polypolish,15558,15561,3
747,Agrobacterium tumefaciens,3,5,At35.1,tig00000004_polypolish,16014,16015,1
748,Agrobacterium tumefaciens,3,5,At35.1,tig00000004_polypolish,17284,17285,1
749,Agrobacterium tumefaciens,3,5,At35.1,tig00000004_polypolish,19043,19044,1
750,Agrobacterium tumefaciens,3,5,At35.1,tig00000004_polypolish,19413,19414,1
751,Agrobacterium tumefaciens,3,5,At35.1,tig00000004_polypolish,20335,20336,1
752,Agrobacterium tumefaciens,3,5,At35.1,tig00000004_polypolish,20948,20949,1
753,Agrobacterium tumefaciens,3,5,At35.1,tig00000004_polypolish,20985,20986,1
754,Agrobacterium tumefaciens,3,5,At35.1,tig00000004_polypolish,26768,26769,1
755,Agrobacterium tumefaciens,3,5,At35.1,tig00000004_polypolish,35702,35703,1
756,Agrobacterium tumefaciens,3,5,At35.1,tig00000004_polypolish,41303,41304,1
757,Agrobacterium tumefaciens,3,5,At35.1,tig00000004_polypolish,54589,54590,1
758,Agrobacterium tumefaciens,3,5,At35.1,tig00000004_polypolish,66251,66252,1
759,Agrobacterium tumefaciens,3,5,At35.1,tig00000004_polypolish,67771,67772,1
760,Agrobacterium tumefaciens,3,5,At35.1,tig00000004_polypolish,124848,124849,1
761,Agrobacterium tumefaciens,3,5,At35.1,tig00000004_polypolish,215208,215209,1
762,Agrobacterium tumefaciens,3,5,At35.1,tig00000004_polypolish,219174,219175,1
763,Agrobacterium tumefaciens,3,5,At35.1,tig00000004_polypolish,219362,219364,2
764,Agrobacterium tumefaciens,3,5,At35.1,tig00000004_polypolish,219613,219614,1
765,Agrobacterium tumefaciens,3,5,At35.1,tig00000004_polypolish,219656,219658,2
766,Agrobacterium tumefaciens,3,5,At35.1,tig00000004_polypolish,219714,219715,1
767,Agrobacterium tumefaciens,3,5,At35.1,tig00000004_polypolish,219790,219791,1
768,Agrobacterium tumefaciens,3,5,At35.1,tig00000004_polypolish,220291,220292,1
769,Agrobacterium tumefaciens,3,5,At35.1,tig00000004_polypolish,220589,220590,1
770,Agrobacterium tumefaciens,3,5,At35.1,tig00000004_polypolish,220741,220742,1
771,Agrobacterium tumefaciens,3,5,At35.1,tig00000004_polypolish,221020,221021,1
772,Agrobacterium tumefaciens,3,5,At35.1,tig00000004_polypolish,221067,221068,1
773,Agrobacterium tumefaciens,3,5,At35.1,tig00000004_polypolish,221196,221197,1
774,Agrobacterium tumefaciens,3,5,At35.1,tig00000004_polypolish,221293,221294,1
775,Agrobacterium tumefaciens,3,5,At35.1,tig00000004_polypolish,221341,221342,1
776,Agrobacterium tumefaciens,3,5,At35.1,tig00000004_polypolish,221395,221396,1
777,Agrobacterium tumefaciens,3,5,At35.1,tig00000004_polypolish,221569,221571,2
778,Agrobacterium tumefaciens,3,5,At35.1,tig00000004_polypolish,221890,221891,1
779,Agrobacterium tumefaciens,3,5,At35.1,tig00000004_polypolish,222349,222350,1
780,Agrobacterium tumefaciens,3,5,At35.1,tig00000004_polypolish,222508,222509,1
781,Agrobacterium tumefaciens,3,5,At35.1,tig00000004_polypolish,222546,222547,1
782,Agrobacterium tumefaciens,3,5,At35.1,tig00000004_polypolish,222699,222700,1
783,Agrobacterium tumefaciens,3,5,At35.1,tig00000004_polypolish,222775,222776,1
784,Agrobacterium tumefaciens,3,5,At35.1,tig00000004_polypolish,222975,222976,1
785,Agrobacterium tumefaciens,3,5,At35.1,tig00000004_polypolish,223118,223119,1
786,Agrobacterium tumefaciens,3,5,At35.1,tig00000004_polypolish,223198,223199,1
787,Agrobacterium tumefaciens,3,5,At35.1,tig00000004_polypolish,223454,223455,1
788,Agrobacterium tumefaciens,3,5,At35.1,tig00000004_polypolish,223639,223640,1
789,Agrobacterium tumefaciens,3,5,At35.1,tig00000004_polypolish,223733,223734,1
790,Agrobacterium tumefaciens,3,5,At35.1,tig00000004_polypolish,224011,224012,1
791,Agrobacterium tumefaciens,3,5,At35.1,tig00000004_polypolish,224018,224019,1
792,Agrobacterium tumefaciens,3,5,At35.1,tig00000004_polypolish,224049,224050,1
793,Agrobacterium tumefaciens,3,5,At35.1,tig00000004_polypolish,224061,229503,5442
794,Agrobacterium tumefaciens,3,5,At35.1,tig00000005_polypolish,0,1365,1365
795,Agrobacterium tumefaciens,3,5,At35.1,tig00000005_polypolish,1682,1683,1
796,Agrobacterium tumefaciens,3,5,At35.1,tig00000005_polypolish,1729,1731,2
797,Agrobacterium tumefaciens,3,5,At35.1,tig00000005_polypolish,1757,1758,1
798,Agrobacterium tumefaciens,3,5,At35.1,tig00000005_polypolish,1772,1773,1
799,Agrobacterium tumefaciens,3,5,At35.1,tig00000005_polypolish,1866,1867,1
800,Agrobacterium tumefaciens,3,5,At35.1,tig00000005_polypolish,2098,2099,1
801,Agrobacterium tumefaciens,3,5,At35.1,tig00000005_polypolish,4740,4741,1
802,Agrobacterium tumefaciens,3,5,At35.1,tig00000005_polypolish,12946,12947,1
803,Agrobacterium tumefaciens,3,5,At35.1,tig00000005_polypolish,13576,13577,1
804,Agrobacterium tumefaciens,3,5,At35.1,tig00000005_polypolish,15666,15667,1
805,Agrobacterium tumefaciens,3,5,At35.1,tig00000005_polypolish,15994,15995,1
806,Agrobacterium tumefaciens,3,5,At35.1,tig00000005_polypolish,18109,18110,1
807,Agrobacterium tumefaciens,3,5,At35.1,tig00000005_polypolish,20081,20082,1
808,Agrobacterium tumefaciens,3,5,At35.1,tig00000005_polypolish,20623,31114,10491
809,Agrobacterium tumefaciens,4,1,At41.1,tig00000001_polypolish,1,4096,4095
810,Agrobacterium tumefaciens,4,1,At41.1,tig00000001_polypolish,4265,4266,1
811,Agrobacterium tumefaciens,4,1,At41.1,tig00000001_polypolish,4934,4935,1
812,Agrobacterium tumefaciens,4,1,At41.1,tig00000001_polypolish,10741,10742,1
813,Agrobacterium tumefaciens,4,1,At41.1,tig00000001_polypolish,363608,363609,1
814,Agrobacterium tumefaciens,4,1,At41.1,tig00000001_polypolish,535383,535384,1
815,Agrobacterium tumefaciens,4,1,At41.1,tig00000001_polypolish,1486337,1486338,1
816,Agrobacterium tumefaciens,4,1,At41.1,tig00000001_polypolish,2998597,2999962,1365
817,Agrobacterium tumefaciens,4,1,At41.1,tig00000003_polypolish,0,10030,10030
818,Agrobacterium tumefaciens,4,1,At41.1,tig00000003_polypolish,10185,10186,1
819,Agrobacterium tumefaciens,4,1,At41.1,tig00000003_polypolish,10290,10291,1
820,Agrobacterium tumefaciens,4,1,At41.1,tig00000003_polypolish,10410,10411,1
821,Agrobacterium tumefaciens,4,1,At41.1,tig00000003_polypolish,10420,10423,3
822,Agrobacterium tumefaciens,4,1,At41.1,tig00000003_polypolish,10501,10502,1
823,Agrobacterium tumefaciens,4,1,At41.1,tig00000003_polypolish,10578,10579,1
824,Agrobacterium tumefaciens,4,1,At41.1,tig00000003_polypolish,10611,10612,1
825,Agrobacterium tumefaciens,4,1,At41.1,tig00000003_polypolish,10660,10661,1
826,Agrobacterium tumefaciens,4,1,At41.1,tig00000003_polypolish,11011,11012,1
827,Agrobacterium tumefaciens,4,1,At41.1,tig00000003_polypolish,11014,11015,1
828,Agrobacterium tumefaciens,4,1,At41.1,tig00000003_polypolish,11341,11342,1
829,Agrobacterium tumefaciens,4,1,At41.1,tig00000003_polypolish,11407,11408,1
830,Agrobacterium tumefaciens,4,1,At41.1,tig00000003_polypolish,11521,11522,1
831,Agrobacterium tumefaciens,4,1,At41.1,tig00000003_polypolish,11761,11762,1
832,Agrobacterium tumefaciens,4,1,At41.1,tig00000003_polypolish,11897,11898,1
833,Agrobacterium tumefaciens,4,1,At41.1,tig00000003_polypolish,15087,15088,1
834,Agrobacterium tumefaciens,4,1,At41.1,tig00000003_polypolish,152998,153000,2
835,Agrobacterium tumefaciens,4,1,At41.1,tig00000003_polypolish,153002,153003,1
836,Agrobacterium tumefaciens,4,1,At41.1,tig00000003_polypolish,153016,153018,2
837,Agrobacterium tumefaciens,4,1,At41.1,tig00000003_polypolish,153026,153028,2
838,Agrobacterium tumefaciens,4,1,At41.1,tig00000003_polypolish,153037,153038,1
839,Agrobacterium tumefaciens,4,1,At41.1,tig00000003_polypolish,153048,153049,1
840,Agrobacterium tumefaciens,4,1,At41.1,tig00000003_polypolish,153051,153054,3
841,Agrobacterium tumefaciens,4,1,At41.1,tig00000003_polypolish,153058,153072,14
842,Agrobacterium tumefaciens,4,1,At41.1,tig00000003_polypolish,153075,153076,1
843,Agrobacterium tumefaciens,4,1,At41.1,tig00000003_polypolish,153083,153084,1
844,Agrobacterium tumefaciens,4,1,At41.1,tig00000003_polypolish,153086,153087,1
845,Agrobacterium tumefaciens,4,1,At41.1,tig00000003_polypolish,153090,153091,1
846,Agrobacterium tumefaciens,4,1,At41.1,tig00000003_polypolish,153104,153108,4
847,Agrobacterium tumefaciens,4,1,At41.1,tig00000003_polypolish,153121,153125,4
848,Agrobacterium tumefaciens,4,1,At41.1,tig00000003_polypolish,153130,153131,1
849,Agrobacterium tumefaciens,4,1,At41.1,tig00000003_polypolish,153132,153134,2
850,Agrobacterium tumefaciens,4,1,At41.1,tig00000003_polypolish,153135,153136,1
851,Agrobacterium tumefaciens,4,1,At41.1,tig00000003_polypolish,153141,153142,1
852,Agrobacterium tumefaciens,4,1,At41.1,tig00000003_polypolish,153154,153271,117
853,Agrobacterium tumefaciens,4,1,At41.1,tig00000003_polypolish,153293,153673,380
854,Agrobacterium tumefaciens,4,1,At41.1,tig00000003_polypolish,153681,153685,4
855,Agrobacterium tumefaciens,4,1,At41.1,tig00000003_polypolish,153705,153707,2
856,Agrobacterium tumefaciens,4,1,At41.1,tig00000003_polypolish,153733,153734,1
857,Agrobacterium tumefaciens,4,1,At41.1,tig00000003_polypolish,153743,153744,1
858,Agrobacterium tumefaciens,4,1,At41.1,tig00000003_polypolish,153751,153753,2
859,Agrobacterium tumefaciens,4,1,At41.1,tig00000003_polypolish,153754,153755,1
860,Agrobacterium tumefaciens,4,1,At41.1,tig00000003_polypolish,153765,153766,1
861,Agrobacterium tumefaciens,4,1,At41.1,tig00000003_polypolish,153775,153831,56
862,Agrobacterium tumefaciens,4,1,At41.1,tig00000003_polypolish,153853,153862,9
863,Agrobacterium tumefaciens,4,1,At41.1,tig00000003_polypolish,153883,153884,1
864,Agrobacterium tumefaciens,4,1,At41.1,tig00000003_polypolish,153890,153892,2
865,Agrobacterium tumefaciens,4,1,At41.1,tig00000003_polypolish,153901,154091,190
866,Agrobacterium tumefaciens,4,1,At41.1,tig00000003_polypolish,154095,154096,1
867,Agrobacterium tumefaciens,4,1,At41.1,tig00000003_polypolish,154100,154101,1
868,Agrobacterium tumefaciens,4,1,At41.1,tig00000003_polypolish,154106,154110,4
869,Agrobacterium tumefaciens,4,1,At41.1,tig00000003_polypolish,154111,154114,3
870,Agrobacterium tumefaciens,4,1,At41.1,tig00000003_polypolish,154123,154150,27
871,Agrobacterium tumefaciens,4,1,At41.1,tig00000003_polypolish,154162,154163,1
872,Agrobacterium tumefaciens,4,1,At41.1,tig00000003_polypolish,154171,154173,2
873,Agrobacterium tumefaciens,4,1,At41.1,tig00000003_polypolish,154178,154179,1
874,Agrobacterium tumefaciens,4,1,At41.1,tig00000003_polypolish,154181,154182,1
875,Agrobacterium tumefaciens,4,1,At41.1,tig00000003_polypolish,154191,154194,3
876,Agrobacterium tumefaciens,4,1,At41.1,tig00000003_polypolish,154211,154215,4
877,Agrobacterium tumefaciens,4,1,At41.1,tig00000003_polypolish,154224,154226,2
878,Agrobacterium tumefaciens,4,1,At41.1,tig00000003_polypolish,154230,154231,1
879,Agrobacterium tumefaciens,4,1,At41.1,tig00000003_polypolish,154234,154362,128
880,Agrobacterium tumefaciens,4,1,At41.1,tig00000003_polypolish,154371,154372,1
881,Agrobacterium tumefaciens,4,1,At41.1,tig00000003_polypolish,154376,154377,1
882,Agrobacterium tumefaciens,4,1,At41.1,tig00000003_polypolish,154391,154393,2
883,Agrobacterium tumefaciens,4,1,At41.1,tig00000003_polypolish,154407,154410,3
884,Agrobacterium tumefaciens,4,1,At41.1,tig00000003_polypolish,154411,154412,1
885,Agrobacterium tumefaciens,4,1,At41.1,tig00000003_polypolish,154420,154421,1
886,Agrobacterium tumefaciens,4,1,At41.1,tig00000003_polypolish,154446,154448,2
887,Agrobacterium tumefaciens,4,1,At41.1,tig00000003_polypolish,154454,154455,1
888,Agrobacterium tumefaciens,4,1,At41.1,tig00000003_polypolish,154469,154472,3
889,Agrobacterium tumefaciens,4,1,At41.1,tig00000003_polypolish,154481,154483,2
890,Agrobacterium tumefaciens,4,1,At41.1,tig00000003_polypolish,154488,154489,1
891,Agrobacterium tumefaciens,4,1,At41.1,tig00000003_polypolish,154496,154500,4
892,Agrobacterium tumefaciens,4,1,At41.1,tig00000003_polypolish,154503,154504,1
893,Agrobacterium tumefaciens,4,1,At41.1,tig00000003_polypolish,154506,154510,4
894,Agrobacterium tumefaciens,4,1,At41.1,tig00000003_polypolish,154520,154527,7
895,Agrobacterium tumefaciens,4,1,At41.1,tig00000003_polypolish,154531,154533,2
896,Agrobacterium tumefaciens,4,1,At41.1,tig00000003_polypolish,154558,154559,1
897,Agrobacterium tumefaciens,4,1,At41.1,tig00000003_polypolish,154565,154568,3
898,Agrobacterium tumefaciens,4,1,At41.1,tig00000003_polypolish,154571,154572,1
899,Agrobacterium tumefaciens,4,1,At41.1,tig00000003_polypolish,154581,154583,2
900,Agrobacterium tumefaciens,4,1,At41.1,tig00000003_polypolish,154587,154588,1
901,Agrobacterium tumefaciens,4,1,At41.1,tig00000003_polypolish,154599,154601,2
902,Agrobacterium tumefaciens,4,1,At41.1,tig00000003_polypolish,154610,154611,1
903,Agrobacterium tumefaciens,4,1,At41.1,tig00000003_polypolish,154630,154638,8
904,Agrobacterium tumefaciens,4,1,At41.1,tig00000003_polypolish,154644,154645,1
905,Agrobacterium tumefaciens,4,1,At41.1,tig00000003_polypolish,154650,154651,1
906,Agrobacterium tumefaciens,4,1,At41.1,tig00000003_polypolish,154665,154666,1
907,Agrobacterium tumefaciens,4,1,At41.1,tig00000003_polypolish,154667,154669,2
908,Agrobacterium tumefaciens,4,1,At41.1,tig00000003_polypolish,154673,154678,5
909,Agrobacterium tumefaciens,4,1,At41.1,tig00000003_polypolish,154683,154685,2
910,Agrobacterium tumefaciens,4,1,At41.1,tig00000003_polypolish,154703,154704,1
911,Agrobacterium tumefaciens,4,1,At41.1,tig00000003_polypolish,154706,154707,1
912,Agrobacterium tumefaciens,4,1,At41.1,tig00000003_polypolish,154708,154709,1
913,Agrobacterium tumefaciens,4,1,At41.1,tig00000003_polypolish,154716,154717,1
914,Agrobacterium tumefaciens,4,1,At41.1,tig00000003_polypolish,154744,154748,4
915,Agrobacterium tumefaciens,4,1,At41.1,tig00000003_polypolish,154754,154756,2
916,Agrobacterium tumefaciens,4,1,At41.1,tig00000003_polypolish,154762,154765,3
917,Agrobacterium tumefaciens,4,1,At41.1,tig00000003_polypolish,154766,154768,2
918,Agrobacterium tumefaciens,4,1,At41.1,tig00000003_polypolish,154775,154776,1
919,Agrobacterium tumefaciens,4,1,At41.1,tig00000003_polypolish,154777,154778,1
920,Agrobacterium tumefaciens,4,1,At41.1,tig00000003_polypolish,154795,154799,4
921,Agrobacterium tumefaciens,4,1,At41.1,tig00000003_polypolish,154808,154812,4
922,Agrobacterium tumefaciens,4,1,At41.1,tig00000003_polypolish,154818,154819,1
923,Agrobacterium tumefaciens,4,1,At41.1,tig00000003_polypolish,154821,154822,1
924,Agrobacterium tumefaciens,4,1,At41.1,tig00000003_polypolish,154836,154899,63
925,Agrobacterium tumefaciens,4,1,At41.1,tig00000003_polypolish,154904,154909,5
926,Agrobacterium tumefaciens,4,1,At41.1,tig00000003_polypolish,154914,154920,6
927,Agrobacterium tumefaciens,4,1,At41.1,tig00000003_polypolish,154922,154925,3
928,Agrobacterium tumefaciens,4,1,At41.1,tig00000003_polypolish,154931,154933,2
929,Agrobacterium tumefaciens,4,1,At41.1,tig00000003_polypolish,154935,154936,1
930,Agrobacterium tumefaciens,4,1,At41.1,tig00000003_polypolish,154942,154945,3
931,Agrobacterium tumefaciens,4,1,At41.1,tig00000003_polypolish,154946,154951,5
932,Agrobacterium tumefaciens,4,1,At41.1,tig00000003_polypolish,154978,154979,1
933,Agrobacterium tumefaciens,4,1,At41.1,tig00000003_polypolish,154983,154986,3
934,Agrobacterium tumefaciens,4,1,At41.1,tig00000003_polypolish,155020,155022,2
935,Agrobacterium tumefaciens,4,1,At41.1,tig00000003_polypolish,155037,155038,1
936,Agrobacterium tumefaciens,4,1,At41.1,tig00000003_polypolish,155064,155065,1
937,Agrobacterium tumefaciens,4,1,At41.1,tig00000003_polypolish,155071,155073,2
938,Agrobacterium tumefaciens,4,1,At41.1,tig00000003_polypolish,155079,155081,2
939,Agrobacterium tumefaciens,4,1,At41.1,tig00000003_polypolish,155082,155083,1
940,Agrobacterium tumefaciens,4,1,At41.1,tig00000003_polypolish,155091,155092,1
941,Agrobacterium tumefaciens,4,1,At41.1,tig00000003_polypolish,155104,155108,4
942,Agrobacterium tumefaciens,4,1,At41.1,tig00000003_polypolish,155118,155119,1
943,Agrobacterium tumefaciens,4,1,At41.1,tig00000003_polypolish,155123,155125,2
944,Agrobacterium tumefaciens,4,1,At41.1,tig00000003_polypolish,155133,155134,1
945,Agrobacterium tumefaciens,4,1,At41.1,tig00000003_polypolish,155140,155240,100
946,Agrobacterium tumefaciens,4,1,At41.1,tig00000003_polypolish,155262,155266,4
947,Agrobacterium tumefaciens,4,1,At41.1,tig00000003_polypolish,155267,155268,1
948,Agrobacterium tumefaciens,4,1,At41.1,tig00000003_polypolish,155270,155272,2
949,Agrobacterium tumefaciens,4,1,At41.1,tig00000003_polypolish,155277,155280,3
950,Agrobacterium tumefaciens,4,1,At41.1,tig00000003_polypolish,155287,155288,1
951,Agrobacterium tumefaciens,4,1,At41.1,tig00000003_polypolish,155291,155293,2
952,Agrobacterium tumefaciens,4,1,At41.1,tig00000003_polypolish,155295,155296,1
953,Agrobacterium tumefaciens,4,1,At41.1,tig00000003_polypolish,155302,155304,2
954,Agrobacterium tumefaciens,4,1,At41.1,tig00000003_polypolish,155305,155306,1
955,Agrobacterium tumefaciens,4,1,At41.1,tig00000003_polypolish,155316,155317,1
956,Agrobacterium tumefaciens,4,1,At41.1,tig00000003_polypolish,155337,155338,1
957,Agrobacterium tumefaciens,4,1,At41.1,tig00000003_polypolish,155349,155350,1
958,Agrobacterium tumefaciens,4,1,At41.1,tig00000003_polypolish,155358,155360,2
959,Agrobacterium tumefaciens,4,1,At41.1,tig00000003_polypolish,155365,155367,2
960,Agrobacterium tumefaciens,4,1,At41.1,tig00000003_polypolish,155375,155376,1
961,Agrobacterium tumefaciens,4,1,At41.1,tig00000003_polypolish,155387,155389,2
962,Agrobacterium tumefaciens,4,1,At41.1,tig00000003_polypolish,155416,155418,2
963,Agrobacterium tumefaciens,4,1,At41.1,tig00000003_polypolish,155420,155421,1
964,Agrobacterium tumefaciens,4,1,At41.1,tig00000003_polypolish,155422,155423,1
965,Agrobacterium tumefaciens,4,1,At41.1,tig00000003_polypolish,155444,155451,7
966,Agrobacterium tumefaciens,4,1,At41.1,tig00000003_polypolish,155454,155456,2
967,Agrobacterium tumefaciens,4,1,At41.1,tig00000003_polypolish,155461,155629,168
968,Agrobacterium tumefaciens,4,1,At41.1,tig00000003_polypolish,155638,155641,3
969,Agrobacterium tumefaciens,4,1,At41.1,tig00000003_polypolish,155647,155650,3
970,Agrobacterium tumefaciens,4,1,At41.1,tig00000003_polypolish,155659,155661,2
971,Agrobacterium tumefaciens,4,1,At41.1,tig00000003_polypolish,155662,155663,1
972,Agrobacterium tumefaciens,4,1,At41.1,tig00000003_polypolish,155682,155683,1
973,Agrobacterium tumefaciens,4,1,At41.1,tig00000003_polypolish,155686,155688,2
974,Agrobacterium tumefaciens,4,1,At41.1,tig00000003_polypolish,155703,155708,5
975,Agrobacterium tumefaciens,4,1,At41.1,tig00000003_polypolish,155713,156226,513
976,Agrobacterium tumefaciens,4,1,At41.1,tig00000003_polypolish,156243,156247,4
977,Agrobacterium tumefaciens,4,1,At41.1,tig00000003_polypolish,156251,156255,4
978,Agrobacterium tumefaciens,4,1,At41.1,tig00000003_polypolish,156263,156265,2
979,Agrobacterium tumefaciens,4,1,At41.1,tig00000003_polypolish,156269,156272,3
980,Agrobacterium tumefaciens,4,1,At41.1,tig00000003_polypolish,156274,156276,2
981,Agrobacterium tumefaciens,4,1,At41.1,tig00000003_polypolish,156281,156284,3
982,Agrobacterium tumefaciens,4,1,At41.1,tig00000003_polypolish,156291,156293,2
983,Agrobacterium tumefaciens,4,1,At41.1,tig00000003_polypolish,156300,156303,3
984,Agrobacterium tumefaciens,4,1,At41.1,tig00000003_polypolish,156306,156309,3
985,Agrobacterium tumefaciens,4,1,At41.1,tig00000003_polypolish,156313,156314,1
986,Agrobacterium tumefaciens,4,1,At41.1,tig00000003_polypolish,156315,156318,3
987,Agrobacterium tumefaciens,4,1,At41.1,tig00000003_polypolish,156324,156326,2
988,Agrobacterium tumefaciens,4,1,At41.1,tig00000003_polypolish,156328,156330,2
989,Agrobacterium tumefaciens,4,1,At41.1,tig00000003_polypolish,156335,156339,4
990,Agrobacterium tumefaciens,4,1,At41.1,tig00000003_polypolish,156341,156344,3
991,Agrobacterium tumefaciens,4,1,At41.1,tig00000003_polypolish,156357,156361,4
992,Agrobacterium tumefaciens,4,1,At41.1,tig00000003_polypolish,156365,156367,2
993,Agrobacterium tumefaciens,4,1,At41.1,tig00000003_polypolish,156379,156381,2
994,Agrobacterium tumefaciens,4,1,At41.1,tig00000003_polypolish,156400,156402,2
995,Agrobacterium tumefaciens,4,1,At41.1,tig00000003_polypolish,156408,156411,3
996,Agrobacterium tumefaciens,4,1,At41.1,tig00000003_polypolish,156412,156413,1
997,Agrobacterium tumefaciens,4,1,At41.1,tig00000003_polypolish,156431,156433,2
998,Agrobacterium tumefaciens,4,1,At41.1,tig00000003_polypolish,156445,156446,1
999,Agrobacterium tumefaciens,4,1,At41.1,tig00000003_polypolish,156447,156449,2
1000,Agrobacterium tumefaciens,4,1,At41.1,tig00000003_polypolish,156452,156464,12
1001,Agrobacterium tumefaciens,4,1,At41.1,tig00000003_polypolish,156482,156484,2
1002,Agrobacterium tumefaciens,4,1,At41.1,tig00000003_polypolish,156489,156492,3
1003,Agrobacterium tumefaciens,4,1,At41.1,tig00000003_polypolish,156505,156507,2
1004,Agrobacterium tumefaciens,4,1,At41.1,tig00000003_polypolish,156539,156543,4
1005,Agrobacterium tumefaciens,4,1,At41.1,tig00000003_polypolish,156544,156546,2
1006,Agrobacterium tumefaciens,4,1,At41.1,tig00000003_polypolish,156548,156550,2
1007,Agrobacterium tumefaciens,4,1,At41.1,tig00000003_polypolish,156586,156587,1
1008,Agrobacterium tumefaciens,4,1,At41.1,tig00000003_polypolish,156593,156594,1
1009,Agrobacterium tumefaciens,4,1,At41.1,tig00000003_polypolish,156596,156597,1
1010,Agrobacterium tumefaciens,4,1,At41.1,tig00000003_polypolish,156621,156622,1
1011,Agrobacterium tumefaciens,4,1,At41.1,tig00000003_polypolish,156627,156629,2
1012,Agrobacterium tumefaciens,4,1,At41.1,tig00000003_polypolish,156644,156645,1
1013,Agrobacterium tumefaciens,4,1,At41.1,tig00000003_polypolish,156654,156655,1
1014,Agrobacterium tumefaciens,4,1,At41.1,tig00000003_polypolish,156663,156667,4
1015,Agrobacterium tumefaciens,4,1,At41.1,tig00000003_polypolish,156711,156712,1
1016,Agrobacterium tumefaciens,4,1,At41.1,tig00000003_polypolish,156716,156718,2
1017,Agrobacterium tumefaciens,4,1,At41.1,tig00000003_polypolish,156727,156732,5
1018,Agrobacterium tumefaciens,4,1,At41.1,tig00000003_polypolish,156738,156742,4
1019,Agrobacterium tumefaciens,4,1,At41.1,tig00000003_polypolish,156745,156747,2
1020,Agrobacterium tumefaciens,4,1,At41.1,tig00000003_polypolish,156750,156754,4
1021,Agrobacterium tumefaciens,4,1,At41.1,tig00000003_polypolish,156758,156759,1
1022,Agrobacterium tumefaciens,4,1,At41.1,tig00000003_polypolish,156773,156774,1
1023,Agrobacterium tumefaciens,4,1,At41.1,tig00000003_polypolish,156793,156796,3
1024,Agrobacterium tumefaciens,4,1,At41.1,tig00000003_polypolish,156809,156965,156
1025,Agrobacterium tumefaciens,4,1,At41.1,tig00000003_polypolish,156974,156975,1
1026,Agrobacterium tumefaciens,4,1,At41.1,tig00000003_polypolish,156982,156984,2
1027,Agrobacterium tumefaciens,4,1,At41.1,tig00000003_polypolish,157004,157005,1
1028,Agrobacterium tumefaciens,4,1,At41.1,tig00000003_polypolish,157007,157008,1
1029,Agrobacterium tumefaciens,4,1,At41.1,tig00000003_polypolish,157015,157016,1
1030,Agrobacterium tumefaciens,4,1,At41.1,tig00000003_polypolish,157031,157032,1
1031,Agrobacterium tumefaciens,4,1,At41.1,tig00000003_polypolish,157041,157042,1
1032,Agrobacterium tumefaciens,4,1,At41.1,tig00000003_polypolish,157060,157062,2
1033,Agrobacterium tumefaciens,4,1,At41.1,tig00000003_polypolish,157092,157094,2
1034,Agrobacterium tumefaciens,4,1,At41.1,tig00000003_polypolish,157095,157096,1
1035,Agrobacterium tumefaciens,4,1,At41.1,tig00000003_polypolish,157100,157101,1
1036,Agrobacterium tumefaciens,4,1,At41.1,tig00000003_polypolish,157104,157105,1
1037,Agrobacterium tumefaciens,4,1,At41.1,tig00000003_polypolish,157107,157109,2
1038,Agrobacterium tumefaciens,4,1,At41.1,tig00000003_polypolish,157113,157138,25
1039,Agrobacterium tumefaciens,4,1,At41.1,tig00000003_polypolish,157149,157151,2
1040,Agrobacterium tumefaciens,4,1,At41.1,tig00000003_polypolish,157153,157155,2
1041,Agrobacterium tumefaciens,4,1,At41.1,tig00000003_polypolish,157162,157163,1
1042,Agrobacterium tumefaciens,4,1,At41.1,tig00000003_polypolish,157175,157185,10
1043,Agrobacterium tumefaciens,4,1,At41.1,tig00000003_polypolish,157192,157201,9
1044,Agrobacterium tumefaciens,4,1,At41.1,tig00000003_polypolish,157202,157203,1
1045,Agrobacterium tumefaciens,4,1,At41.1,tig00000003_polypolish,157219,157222,3
1046,Agrobacterium tumefaciens,4,1,At41.1,tig00000003_polypolish,157224,157225,1
1047,Agrobacterium tumefaciens,4,1,At41.1,tig00000003_polypolish,157230,157232,2
1048,Agrobacterium tumefaciens,4,1,At41.1,tig00000003_polypolish,157236,157766,530
1049,Agrobacterium tumefaciens,4,1,At41.1,tig00000003_polypolish,157785,157786,1
1050,Agrobacterium tumefaciens,4,1,At41.1,tig00000003_polypolish,157790,157791,1
1051,Agrobacterium tumefaciens,4,1,At41.1,tig00000003_polypolish,157802,157804,2
1052,Agrobacterium tumefaciens,4,1,At41.1,tig00000003_polypolish,157810,158584,774
1053,Agrobacterium tumefaciens,4,1,At41.1,tig00000003_polypolish,158594,158596,2
1054,Agrobacterium tumefaciens,4,1,At41.1,tig00000003_polypolish,158599,158602,3
1055,Agrobacterium tumefaciens,4,1,At41.1,tig00000003_polypolish,203459,203460,1
1056,Agrobacterium tumefaciens,4,1,At41.1,tig00000003_polypolish,205698,205699,1
1057,Agrobacterium tumefaciens,4,1,At41.1,tig00000003_polypolish,207692,207693,1
1058,Agrobacterium tumefaciens,4,1,At41.1,tig00000003_polypolish,207700,207701,1
1059,Agrobacterium tumefaciens,4,1,At41.1,tig00000003_polypolish,207780,207781,1
1060,Agrobacterium tumefaciens,4,1,At41.1,tig00000003_polypolish,207785,207786,1
1061,Agrobacterium tumefaciens,4,1,At41.1,tig00000003_polypolish,207791,207792,1
1062,Agrobacterium tumefaciens,4,1,At41.1,tig00000003_polypolish,208018,208019,1
1063,Agrobacterium tumefaciens,4,1,At41.1,tig00000003_polypolish,208078,208079,1
1064,Agrobacterium tumefaciens,4,1,At41.1,tig00000003_polypolish,208098,208099,1
1065,Agrobacterium tumefaciens,4,1,At41.1,tig00000003_polypolish,208118,208119,1
1066,Agrobacterium tumefaciens,4,1,At41.1,tig00000003_polypolish,209296,209297,1
1067,Agrobacterium tumefaciens,4,1,At41.1,tig00000003_polypolish,209386,209387,1
1068,Agrobacterium tumefaciens,4,1,At41.1,tig00000003_polypolish,209525,213991,4466
1069,Agrobacterium tumefaciens,4,1,At41.1,tig00000004_polypolish,0,5328,5328
1070,Agrobacterium tumefaciens,4,1,At41.1,tig00000004_polypolish,6100,6101,1
1071,Agrobacterium tumefaciens,4,1,At41.1,tig00000004_polypolish,6327,6329,2
1072,Agrobacterium tumefaciens,4,1,At41.1,tig00000004_polypolish,84459,84460,1
1073,Agrobacterium tumefaciens,4,1,At41.1,tig00000004_polypolish,222543,222544,1
1074,Agrobacterium tumefaciens,4,1,At41.1,tig00000004_polypolish,224671,224672,1
1075,Agrobacterium tumefaciens,4,1,At41.1,tig00000004_polypolish,224993,224994,1
1076,Agrobacterium tumefaciens,4,1,At41.1,tig00000004_polypolish,225368,225369,1
1077,Agrobacterium tumefaciens,4,1,At41.1,tig00000004_polypolish,225574,225575,1
1078,Agrobacterium tumefaciens,4,1,At41.1,tig00000004_polypolish,225764,225765,1
1079,Agrobacterium tumefaciens,4,1,At41.1,tig00000004_polypolish,225781,229503,3722
1080,Agrobacterium tumefaciens,4,1,At41.1,tig00000005_polypolish,0,31114,31114
1081,Agrobacterium tumefaciens,4,2,At42.1,tig00000001_polypolish,1,281,280
1082,Agrobacterium tumefaciens,4,2,At42.1,tig00000001_polypolish,427,428,1
1083,Agrobacterium tumefaciens,4,2,At42.1,tig00000001_polypolish,615,616,1
1084,Agrobacterium tumefaciens,4,2,At42.1,tig00000001_polypolish,1532,1533,1
1085,Agrobacterium tumefaciens,4,2,At42.1,tig00000001_polypolish,1891,1892,1
1086,Agrobacterium tumefaciens,4,2,At42.1,tig00000001_polypolish,61072,61078,6
1087,Agrobacterium tumefaciens,4,2,At42.1,tig00000001_polypolish,61080,61083,3
1088,Agrobacterium tumefaciens,4,2,At42.1,tig00000001_polypolish,500636,500638,2
1089,Agrobacterium tumefaciens,4,2,At42.1,tig00000001_polypolish,1326904,1326905,1
1090,Agrobacterium tumefaciens,4,2,At42.1,tig00000001_polypolish,2046604,2046605,1
1091,Agrobacterium tumefaciens,4,2,At42.1,tig00000001_polypolish,2182963,2182975,12
1092,Agrobacterium tumefaciens,4,2,At42.1,tig00000001_polypolish,2597903,2597904,1
1093,Agrobacterium tumefaciens,4,2,At42.1,tig00000001_polypolish,2994961,2994962,1
1094,Agrobacterium tumefaciens,4,2,At42.1,tig00000001_polypolish,2995556,2995557,1
1095,Agrobacterium tumefaciens,4,2,At42.1,tig00000001_polypolish,2995572,2999962,4390
1096,Agrobacterium tumefaciens,4,2,At42.1,tig00000003_polypolish,0,974,974
1097,Agrobacterium tumefaciens,4,2,At42.1,tig00000003_polypolish,11209,11210,1
1098,Agrobacterium tumefaciens,4,2,At42.1,tig00000003_polypolish,61225,61226,1
1099,Agrobacterium tumefaciens,4,2,At42.1,tig00000003_polypolish,76035,76036,1
1100,Agrobacterium tumefaciens,4,2,At42.1,tig00000003_polypolish,77070,77071,1
1101,Agrobacterium tumefaciens,4,2,At42.1,tig00000003_polypolish,77509,77510,1
1102,Agrobacterium tumefaciens,4,2,At42.1,tig00000003_polypolish,85832,85833,1
1103,Agrobacterium tumefaciens,4,2,At42.1,tig00000003_polypolish,87454,87455,1
1104,Agrobacterium tumefaciens,4,2,At42.1,tig00000003_polypolish,101872,101873,1
1105,Agrobacterium tumefaciens,4,2,At42.1,tig00000003_polypolish,102236,102237,1
1106,Agrobacterium tumefaciens,4,2,At42.1,tig00000003_polypolish,107613,107614,1
1107,Agrobacterium tumefaciens,4,2,At42.1,tig00000003_polypolish,122067,122068,1
1108,Agrobacterium tumefaciens,4,2,At42.1,tig00000003_polypolish,131280,131281,1
1109,Agrobacterium tumefaciens,4,2,At42.1,tig00000003_polypolish,134015,134016,1
1110,Agrobacterium tumefaciens,4,2,At42.1,tig00000003_polypolish,147177,147178,1
1111,Agrobacterium tumefaciens,4,2,At42.1,tig00000003_polypolish,156024,156025,1
1112,Agrobacterium tumefaciens,4,2,At42.1,tig00000003_polypolish,184753,184754,1
1113,Agrobacterium tumefaciens,4,2,At42.1,tig00000003_polypolish,203388,213991,10603
1114,Agrobacterium tumefaciens,4,2,At42.1,tig00000004_polypolish,0,2316,2316
1115,Agrobacterium tumefaciens,4,2,At42.1,tig00000004_polypolish,2406,2407,1
1116,Agrobacterium tumefaciens,4,2,At42.1,tig00000004_polypolish,2478,2479,1
1117,Agrobacterium tumefaciens,4,2,At42.1,tig00000004_polypolish,2570,2571,1
1118,Agrobacterium tumefaciens,4,2,At42.1,tig00000004_polypolish,2631,2632,1
1119,Agrobacterium tumefaciens,4,2,At42.1,tig00000004_polypolish,2659,2660,1
1120,Agrobacterium tumefaciens,4,2,At42.1,tig00000004_polypolish,2665,2666,1
1121,Agrobacterium tumefaciens,4,2,At42.1,tig00000004_polypolish,2829,2830,1
1122,Agrobacterium tumefaciens,4,2,At42.1,tig00000004_polypolish,2863,2864,1
1123,Agrobacterium tumefaciens,4,2,At42.1,tig00000004_polypolish,3075,3076,1
1124,Agrobacterium tumefaciens,4,2,At42.1,tig00000004_polypolish,3095,3096,1
1125,Agrobacterium tumefaciens,4,2,At42.1,tig00000004_polypolish,3139,3140,1
1126,Agrobacterium tumefaciens,4,2,At42.1,tig00000004_polypolish,3541,3542,1
1127,Agrobacterium tumefaciens,4,2,At42.1,tig00000004_polypolish,3568,3569,1
1128,Agrobacterium tumefaciens,4,2,At42.1,tig00000004_polypolish,10550,10551,1
1129,Agrobacterium tumefaciens,4,2,At42.1,tig00000004_polypolish,12183,12184,1
1130,Agrobacterium tumefaciens,4,2,At42.1,tig00000004_polypolish,12742,12743,1
1131,Agrobacterium tumefaciens,4,2,At42.1,tig00000004_polypolish,18983,18984,1
1132,Agrobacterium tumefaciens,4,2,At42.1,tig00000004_polypolish,19020,19021,1
1133,Agrobacterium tumefaciens,4,2,At42.1,tig00000004_polypolish,20335,20336,1
1134,Agrobacterium tumefaciens,4,2,At42.1,tig00000004_polypolish,20758,20759,1
1135,Agrobacterium tumefaciens,4,2,At42.1,tig00000004_polypolish,21780,21781,1
1136,Agrobacterium tumefaciens,4,2,At42.1,tig00000004_polypolish,22348,22349,1
1137,Agrobacterium tumefaciens,4,2,At42.1,tig00000004_polypolish,26768,26769,1
1138,Agrobacterium tumefaciens,4,2,At42.1,tig00000004_polypolish,26832,26833,1
1139,Agrobacterium tumefaciens,4,2,At42.1,tig00000004_polypolish,29751,29752,1
1140,Agrobacterium tumefaciens,4,2,At42.1,tig00000004_polypolish,30094,30095,1
1141,Agrobacterium tumefaciens,4,2,At42.1,tig00000004_polypolish,31101,31102,1
1142,Agrobacterium tumefaciens,4,2,At42.1,tig00000004_polypolish,37561,37562,1
1143,Agrobacterium tumefaciens,4,2,At42.1,tig00000004_polypolish,38012,38013,1
1144,Agrobacterium tumefaciens,4,2,At42.1,tig00000004_polypolish,38408,38409,1
1145,Agrobacterium tumefaciens,4,2,At42.1,tig00000004_polypolish,39123,39124,1
1146,Agrobacterium tumefaciens,4,2,At42.1,tig00000004_polypolish,39760,39761,1
1147,Agrobacterium tumefaciens,4,2,At42.1,tig00000004_polypolish,40585,40586,1
1148,Agrobacterium tumefaciens,4,2,At42.1,tig00000004_polypolish,40875,40876,1
1149,Agrobacterium tumefaciens,4,2,At42.1,tig00000004_polypolish,99683,99684,1
1150,Agrobacterium tumefaciens,4,2,At42.1,tig00000004_polypolish,101798,101799,1
1151,Agrobacterium tumefaciens,4,2,At42.1,tig00000004_polypolish,103867,103868,1
1152,Agrobacterium tumefaciens,4,2,At42.1,tig00000004_polypolish,105912,105913,1
1153,Agrobacterium tumefaciens,4,2,At42.1,tig00000004_polypolish,106410,106411,1
1154,Agrobacterium tumefaciens,4,2,At42.1,tig00000004_polypolish,107069,107070,1
1155,Agrobacterium tumefaciens,4,2,At42.1,tig00000004_polypolish,109878,109879,1
1156,Agrobacterium tumefaciens,4,2,At42.1,tig00000004_polypolish,129267,129268,1
1157,Agrobacterium tumefaciens,4,2,At42.1,tig00000004_polypolish,150769,150771,2
1158,Agrobacterium tumefaciens,4,2,At42.1,tig00000004_polypolish,151591,151592,1
1159,Agrobacterium tumefaciens,4,2,At42.1,tig00000004_polypolish,151642,151643,1
1160,Agrobacterium tumefaciens,4,2,At42.1,tig00000004_polypolish,152159,152169,10
1161,Agrobacterium tumefaciens,4,2,At42.1,tig00000004_polypolish,152256,152259,3
1162,Agrobacterium tumefaciens,4,2,At42.1,tig00000004_polypolish,152264,152266,2
1163,Agrobacterium tumefaciens,4,2,At42.1,tig00000004_polypolish,152276,152278,2
1164,Agrobacterium tumefaciens,4,2,At42.1,tig00000004_polypolish,152300,170559,18259
1165,Agrobacterium tumefaciens,4,2,At42.1,tig00000004_polypolish,173176,173177,1
1166,Agrobacterium tumefaciens,4,2,At42.1,tig00000004_polypolish,191427,191428,1
1167,Agrobacterium tumefaciens,4,2,At42.1,tig00000004_polypolish,193045,193046,1
1168,Agrobacterium tumefaciens,4,2,At42.1,tig00000004_polypolish,194721,194722,1
1169,Agrobacterium tumefaciens,4,2,At42.1,tig00000004_polypolish,194780,194781,1
1170,Agrobacterium tumefaciens,4,2,At42.1,tig00000004_polypolish,194819,194820,1
1171,Agrobacterium tumefaciens,4,2,At42.1,tig00000004_polypolish,194909,194910,1
1172,Agrobacterium tumefaciens,4,2,At42.1,tig00000004_polypolish,194935,194936,1
1173,Agrobacterium tumefaciens,4,2,At42.1,tig00000004_polypolish,195046,195047,1
1174,Agrobacterium tumefaciens,4,2,At42.1,tig00000004_polypolish,195088,195089,1
1175,Agrobacterium tumefaciens,4,2,At42.1,tig00000004_polypolish,195156,195157,1
1176,Agrobacterium tumefaciens,4,2,At42.1,tig00000004_polypolish,195179,195180,1
1177,Agrobacterium tumefaciens,4,2,At42.1,tig00000004_polypolish,195364,195365,1
1178,Agrobacterium tumefaciens,4,2,At42.1,tig00000004_polypolish,195799,195800,1
1179,Agrobacterium tumefaciens,4,2,At42.1,tig00000004_polypolish,195842,195843,1
1180,Agrobacterium tumefaciens,4,2,At42.1,tig00000004_polypolish,195962,195963,1
1181,Agrobacterium tumefaciens,4,2,At42.1,tig00000004_polypolish,196414,196415,1
1182,Agrobacterium tumefaciens,4,2,At42.1,tig00000004_polypolish,196622,196623,1
1183,Agrobacterium tumefaciens,4,2,At42.1,tig00000004_polypolish,218913,218914,1
1184,Agrobacterium tumefaciens,4,2,At42.1,tig00000004_polypolish,219115,219116,1
1185,Agrobacterium tumefaciens,4,2,At42.1,tig00000004_polypolish,223989,223990,1
1186,Agrobacterium tumefaciens,4,2,At42.1,tig00000004_polypolish,225764,225765,1
1187,Agrobacterium tumefaciens,4,2,At42.1,tig00000004_polypolish,225793,229503,3710
1188,Agrobacterium tumefaciens,4,2,At42.1,tig00000005_polypolish,201,202,1
1189,Agrobacterium tumefaciens,4,2,At42.1,tig00000005_polypolish,315,316,1
1190,Agrobacterium tumefaciens,4,2,At42.1,tig00000005_polypolish,438,439,1
1191,Agrobacterium tumefaciens,4,2,At42.1,tig00000005_polypolish,523,524,1
1192,Agrobacterium tumefaciens,4,2,At42.1,tig00000005_polypolish,625,626,1
1193,Agrobacterium tumefaciens,4,2,At42.1,tig00000005_polypolish,730,731,1
1194,Agrobacterium tumefaciens,4,2,At42.1,tig00000005_polypolish,978,979,1
1195,Agrobacterium tumefaciens,4,2,At42.1,tig00000005_polypolish,1209,1210,1
1196,Agrobacterium tumefaciens,4,2,At42.1,tig00000005_polypolish,1313,1314,1
1197,Agrobacterium tumefaciens,4,2,At42.1,tig00000005_polypolish,1861,1862,1
1198,Agrobacterium tumefaciens,4,2,At42.1,tig00000005_polypolish,2562,2563,1
1199,Agrobacterium tumefaciens,4,2,At42.1,tig00000005_polypolish,2781,2782,1
1200,Agrobacterium tumefaciens,4,2,At42.1,tig00000005_polypolish,3079,3080,1
1201,Agrobacterium tumefaciens,4,2,At42.1,tig00000005_polypolish,3282,3283,1
1202,Agrobacterium tumefaciens,4,2,At42.1,tig00000005_polypolish,3378,3379,1
1203,Agrobacterium tumefaciens,4,2,At42.1,tig00000005_polypolish,3804,3805,1
1204,Agrobacterium tumefaciens,4,2,At42.1,tig00000005_polypolish,3829,3830,1
1205,Agrobacterium tumefaciens,4,2,At42.1,tig00000005_polypolish,3934,3935,1
1206,Agrobacterium tumefaciens,4,2,At42.1,tig00000005_polypolish,3937,3938,1
1207,Agrobacterium tumefaciens,4,2,At42.1,tig00000005_polypolish,4251,4252,1
1208,Agrobacterium tumefaciens,4,2,At42.1,tig00000005_polypolish,4634,4635,1
1209,Agrobacterium tumefaciens,4,2,At42.1,tig00000005_polypolish,4782,4783,1
1210,Agrobacterium tumefaciens,4,2,At42.1,tig00000005_polypolish,5005,5006,1
1211,Agrobacterium tumefaciens,4,2,At42.1,tig00000005_polypolish,5065,5066,1
1212,Agrobacterium tumefaciens,4,2,At42.1,tig00000005_polypolish,5589,5590,1
1213,Agrobacterium tumefaciens,4,2,At42.1,tig00000005_polypolish,5663,5664,1
1214,Agrobacterium tumefaciens,4,2,At42.1,tig00000005_polypolish,5818,5819,1
1215,Agrobacterium tumefaciens,4,2,At42.1,tig00000005_polypolish,6186,6187,1
1216,Agrobacterium tumefaciens,4,2,At42.1,tig00000005_polypolish,6232,6233,1
1217,Agrobacterium tumefaciens,4,2,At42.1,tig00000005_polypolish,6305,6306,1
1218,Agrobacterium tumefaciens,4,2,At42.1,tig00000005_polypolish,6891,6893,2
1219,Agrobacterium tumefaciens,4,2,At42.1,tig00000005_polypolish,7339,7340,1
1220,Agrobacterium tumefaciens,4,2,At42.1,tig00000005_polypolish,7485,7486,1
1221,Agrobacterium tumefaciens,4,2,At42.1,tig00000005_polypolish,7606,7607,1
1222,Agrobacterium tumefaciens,4,2,At42.1,tig00000005_polypolish,7617,24755,17138
1223,Agrobacterium tumefaciens,4,2,At42.1,tig00000005_polypolish,24898,24899,1
1224,Agrobacterium tumefaciens,4,2,At42.1,tig00000005_polypolish,24916,24917,1
1225,Agrobacterium tumefaciens,4,2,At42.1,tig00000005_polypolish,25237,25239,2
1226,Agrobacterium tumefaciens,4,2,At42.1,tig00000005_polypolish,25302,25303,1
1227,Agrobacterium tumefaciens,4,2,At42.1,tig00000005_polypolish,25489,25490,1
1228,Agrobacterium tumefaciens,4,2,At42.1,tig00000005_polypolish,25813,25814,1
1229,Agrobacterium tumefaciens,4,2,At42.1,tig00000005_polypolish,25923,25924,1
1230,Agrobacterium tumefaciens,4,2,At42.1,tig00000005_polypolish,26041,26042,1
1231,Agrobacterium tumefaciens,4,2,At42.1,tig00000005_polypolish,26129,26130,1
1232,Agrobacterium tumefaciens,4,2,At42.1,tig00000005_polypolish,26183,26184,1
1233,Agrobacterium tumefaciens,4,2,At42.1,tig00000005_polypolish,26393,26394,1
1234,Agrobacterium tumefaciens,4,2,At42.1,tig00000005_polypolish,26464,26465,1
1235,Agrobacterium tumefaciens,4,2,At42.1,tig00000005_polypolish,26481,26482,1
1236,Agrobacterium tumefaciens,4,2,At42.1,tig00000005_polypolish,26566,26567,1
1237,Agrobacterium tumefaciens,4,2,At42.1,tig00000005_polypolish,26665,26666,1
1238,Agrobacterium tumefaciens,4,2,At42.1,tig00000005_polypolish,26677,26678,1
1239,Agrobacterium tumefaciens,4,2,At42.1,tig00000005_polypolish,26954,26955,1
1240,Agrobacterium tumefaciens,4,2,At42.1,tig00000005_polypolish,27034,27035,1
1241,Agrobacterium tumefaciens,4,2,At42.1,tig00000005_polypolish,27091,27092,1
1242,Agrobacterium tumefaciens,4,2,At42.1,tig00000005_polypolish,27191,27192,1
1243,Agrobacterium tumefaciens,4,2,At42.1,tig00000005_polypolish,27276,27277,1
1244,Agrobacterium tumefaciens,4,2,At42.1,tig00000005_polypolish,27316,27317,1
1245,Agrobacterium tumefaciens,4,2,At42.1,tig00000005_polypolish,27341,27344,3
1246,Agrobacterium tumefaciens,4,2,At42.1,tig00000005_polypolish,27366,27367,1
1247,Agrobacterium tumefaciens,4,2,At42.1,tig00000005_polypolish,27482,27483,1
1248,Agrobacterium tumefaciens,4,2,At42.1,tig00000005_polypolish,27561,27562,1
1249,Agrobacterium tumefaciens,4,2,At42.1,tig00000005_polypolish,27610,27611,1
1250,Agrobacterium tumefaciens,4,2,At42.1,tig00000005_polypolish,28049,28050,1
1251,Agrobacterium tumefaciens,4,2,At42.1,tig00000005_polypolish,28089,28090,1
1252,Agrobacterium tumefaciens,4,2,At42.1,tig00000005_polypolish,28277,28278,1
1253,Agrobacterium tumefaciens,4,2,At42.1,tig00000005_polypolish,28396,28397,1
1254,Agrobacterium tumefaciens,4,2,At42.1,tig00000005_polypolish,28705,28706,1
1255,Agrobacterium tumefaciens,4,2,At42.1,tig00000005_polypolish,28966,28967,1
1256,Agrobacterium tumefaciens,4,2,At42.1,tig00000005_polypolish,29031,29032,1
1257,Agrobacterium tumefaciens,4,2,At42.1,tig00000005_polypolish,29096,29097,1
1258,Agrobacterium tumefaciens,4,2,At42.1,tig00000005_polypolish,29450,29451,1
1259,Agrobacterium tumefaciens,4,2,At42.1,tig00000005_polypolish,29564,29565,1
1260,Agrobacterium tumefaciens,4,2,At42.1,tig00000005_polypolish,29687,29688,1
1261,Agrobacterium tumefaciens,4,2,At42.1,tig00000005_polypolish,29772,29773,1
1262,Agrobacterium tumefaciens,4,2,At42.1,tig00000005_polypolish,29874,29875,1
1263,Agrobacterium tumefaciens,4,2,At42.1,tig00000005_polypolish,29979,29980,1
1264,Agrobacterium tumefaciens,4,2,At42.1,tig00000005_polypolish,30227,30228,1
1265,Agrobacterium tumefaciens,4,2,At42.1,tig00000005_polypolish,30458,30459,1
1266,Agrobacterium tumefaciens,4,2,At42.1,tig00000005_polypolish,30562,30563,1
1267,Agrobacterium tumefaciens,4,2,At42.1,tig00000005_polypolish,31106,31107,1
1268,Agrobacterium tumefaciens,4,3,At43.1,tig00000001_polypolish,1,14828,14827
1269,Agrobacterium tumefaciens,4,3,At43.1,tig00000001_polypolish,15272,15273,1
1270,Agrobacterium tumefaciens,4,3,At43.1,tig00000001_polypolish,143530,143531,1
1271,Agrobacterium tumefaciens,4,3,At43.1,tig00000001_polypolish,277967,277968,1
1272,Agrobacterium tumefaciens,4,3,At43.1,tig00000001_polypolish,517113,517114,1
1273,Agrobacterium tumefaciens,4,3,At43.1,tig00000001_polypolish,518779,518780,1
1274,Agrobacterium tumefaciens,4,3,At43.1,tig00000001_polypolish,529332,529333,1
1275,Agrobacterium tumefaciens,4,3,At43.1,tig00000001_polypolish,779672,779673,1
1276,Agrobacterium tumefaciens,4,3,At43.1,tig00000001_polypolish,957065,957066,1
1277,Agrobacterium tumefaciens,4,3,At43.1,tig00000001_polypolish,1129846,1129847,1
1278,Agrobacterium tumefaciens,4,3,At43.1,tig00000001_polypolish,1198184,1199993,1809
1279,Agrobacterium tumefaciens,4,3,At43.1,tig00000001_polypolish,1233931,1233932,1
1280,Agrobacterium tumefaciens,4,3,At43.1,tig00000001_polypolish,1923256,1923257,1
1281,Agrobacterium tumefaciens,4,3,At43.1,tig00000001_polypolish,1975492,1975493,1
1282,Agrobacterium tumefaciens,4,3,At43.1,tig00000001_polypolish,2174507,2174508,1
1283,Agrobacterium tumefaciens,4,3,At43.1,tig00000001_polypolish,2740188,2740189,1
1284,Agrobacterium tumefaciens,4,3,At43.1,tig00000001_polypolish,2961527,2987127,25600
1285,Agrobacterium tumefaciens,4,3,At43.1,tig00000001_polypolish,2987525,2987526,1
1286,Agrobacterium tumefaciens,4,3,At43.1,tig00000001_polypolish,2987796,2987797,1
1287,Agrobacterium tumefaciens,4,3,At43.1,tig00000001_polypolish,2995617,2999962,4345
1288,Agrobacterium tumefaciens,4,3,At43.1,tig00000003_polypolish,0,1280,1280
1289,Agrobacterium tumefaciens,4,3,At43.1,tig00000003_polypolish,3357,3358,1
1290,Agrobacterium tumefaciens,4,3,At43.1,tig00000003_polypolish,43910,43911,1
1291,Agrobacterium tumefaciens,4,3,At43.1,tig00000003_polypolish,46663,46664,1
1292,Agrobacterium tumefaciens,4,3,At43.1,tig00000003_polypolish,48993,48994,1
1293,Agrobacterium tumefaciens,4,3,At43.1,tig00000003_polypolish,49714,49715,1
1294,Agrobacterium tumefaciens,4,3,At43.1,tig00000003_polypolish,49925,49926,1
1295,Agrobacterium tumefaciens,4,3,At43.1,tig00000003_polypolish,50441,50442,1
1296,Agrobacterium tumefaciens,4,3,At43.1,tig00000003_polypolish,50676,50677,1
1297,Agrobacterium tumefaciens,4,3,At43.1,tig00000003_polypolish,51747,51748,1
1298,Agrobacterium tumefaciens,4,3,At43.1,tig00000003_polypolish,51828,51829,1
1299,Agrobacterium tumefaciens,4,3,At43.1,tig00000003_polypolish,52243,52244,1
1300,Agrobacterium tumefaciens,4,3,At43.1,tig00000003_polypolish,56671,56672,1
1301,Agrobacterium tumefaciens,4,3,At43.1,tig00000003_polypolish,85974,85975,1
1302,Agrobacterium tumefaciens,4,3,At43.1,tig00000003_polypolish,87454,87455,1
1303,Agrobacterium tumefaciens,4,3,At43.1,tig00000003_polypolish,127573,127574,1
1304,Agrobacterium tumefaciens,4,3,At43.1,tig00000003_polypolish,165964,165965,1
1305,Agrobacterium tumefaciens,4,3,At43.1,tig00000003_polypolish,209153,209154,1
1306,Agrobacterium tumefaciens,4,3,At43.1,tig00000003_polypolish,210663,210664,1
1307,Agrobacterium tumefaciens,4,3,At43.1,tig00000003_polypolish,212519,212520,1
1308,Agrobacterium tumefaciens,4,3,At43.1,tig00000003_polypolish,212544,213991,1447
1309,Agrobacterium tumefaciens,4,3,At43.1,tig00000004_polypolish,0,2373,2373
1310,Agrobacterium tumefaciens,4,3,At43.1,tig00000004_polypolish,3635,3636,1
1311,Agrobacterium tumefaciens,4,3,At43.1,tig00000004_polypolish,3701,3703,2
1312,Agrobacterium tumefaciens,4,3,At43.1,tig00000004_polypolish,4125,4126,1
1313,Agrobacterium tumefaciens,4,3,At43.1,tig00000004_polypolish,4203,4204,1
1314,Agrobacterium tumefaciens,4,3,At43.1,tig00000004_polypolish,4438,4439,1
1315,Agrobacterium tumefaciens,4,3,At43.1,tig00000004_polypolish,5331,5332,1
1316,Agrobacterium tumefaciens,4,3,At43.1,tig00000004_polypolish,6105,6106,1
1317,Agrobacterium tumefaciens,4,3,At43.1,tig00000004_polypolish,6138,6140,2
1318,Agrobacterium tumefaciens,4,3,At43.1,tig00000004_polypolish,6522,6523,1
1319,Agrobacterium tumefaciens,4,3,At43.1,tig00000004_polypolish,8301,8302,1
1320,Agrobacterium tumefaciens,4,3,At43.1,tig00000004_polypolish,10058,10059,1
1321,Agrobacterium tumefaciens,4,3,At43.1,tig00000004_polypolish,10938,10939,1
1322,Agrobacterium tumefaciens,4,3,At43.1,tig00000004_polypolish,11407,11408,1
1323,Agrobacterium tumefaciens,4,3,At43.1,tig00000004_polypolish,15826,15827,1
1324,Agrobacterium tumefaciens,4,3,At43.1,tig00000004_polypolish,17188,17189,1
1325,Agrobacterium tumefaciens,4,3,At43.1,tig00000004_polypolish,20242,20243,1
1326,Agrobacterium tumefaciens,4,3,At43.1,tig00000004_polypolish,53080,53081,1
1327,Agrobacterium tumefaciens,4,3,At43.1,tig00000004_polypolish,53823,53824,1
1328,Agrobacterium tumefaciens,4,3,At43.1,tig00000004_polypolish,56702,56703,1
1329,Agrobacterium tumefaciens,4,3,At43.1,tig00000004_polypolish,58743,58744,1
1330,Agrobacterium tumefaciens,4,3,At43.1,tig00000004_polypolish,58939,58940,1
1331,Agrobacterium tumefaciens,4,3,At43.1,tig00000004_polypolish,59370,59371,1
1332,Agrobacterium tumefaciens,4,3,At43.1,tig00000004_polypolish,60072,60073,1
1333,Agrobacterium tumefaciens,4,3,At43.1,tig00000004_polypolish,60800,60801,1
1334,Agrobacterium tumefaciens,4,3,At43.1,tig00000004_polypolish,60855,60856,1
1335,Agrobacterium tumefaciens,4,3,At43.1,tig00000004_polypolish,75934,75935,1
1336,Agrobacterium tumefaciens,4,3,At43.1,tig00000004_polypolish,76468,76469,1
1337,Agrobacterium tumefaciens,4,3,At43.1,tig00000004_polypolish,76553,76554,1
1338,Agrobacterium tumefaciens,4,3,At43.1,tig00000004_polypolish,77185,77186,1
1339,Agrobacterium tumefaciens,4,3,At43.1,tig00000004_polypolish,77206,77207,1
1340,Agrobacterium tumefaciens,4,3,At43.1,tig00000004_polypolish,78237,78238,1
1341,Agrobacterium tumefaciens,4,3,At43.1,tig00000004_polypolish,78352,78353,1
1342,Agrobacterium tumefaciens,4,3,At43.1,tig00000004_polypolish,81447,81448,1
1343,Agrobacterium tumefaciens,4,3,At43.1,tig00000004_polypolish,83532,83533,1
1344,Agrobacterium tumefaciens,4,3,At43.1,tig00000004_polypolish,134940,134941,1
1345,Agrobacterium tumefaciens,4,3,At43.1,tig00000004_polypolish,155569,155570,1
1346,Agrobacterium tumefaciens,4,3,At43.1,tig00000004_polypolish,155619,155620,1
1347,Agrobacterium tumefaciens,4,3,At43.1,tig00000004_polypolish,159403,159404,1
1348,Agrobacterium tumefaciens,4,3,At43.1,tig00000004_polypolish,177248,177249,1
1349,Agrobacterium tumefaciens,4,3,At43.1,tig00000004_polypolish,211144,211145,1
1350,Agrobacterium tumefaciens,4,3,At43.1,tig00000004_polypolish,216413,216414,1
1351,Agrobacterium tumefaciens,4,3,At43.1,tig00000004_polypolish,218060,218062,2
1352,Agrobacterium tumefaciens,4,3,At43.1,tig00000004_polypolish,219002,219003,1
1353,Agrobacterium tumefaciens,4,3,At43.1,tig00000004_polypolish,219982,219983,1
1354,Agrobacterium tumefaciens,4,3,At43.1,tig00000004_polypolish,221382,221383,1
1355,Agrobacterium tumefaciens,4,3,At43.1,tig00000004_polypolish,221674,221676,2
1356,Agrobacterium tumefaciens,4,3,At43.1,tig00000004_polypolish,221728,221729,1
1357,Agrobacterium tumefaciens,4,3,At43.1,tig00000004_polypolish,222258,222259,1
1358,Agrobacterium tumefaciens,4,3,At43.1,tig00000004_polypolish,222300,222301,1
1359,Agrobacterium tumefaciens,4,3,At43.1,tig00000004_polypolish,222986,222987,1
1360,Agrobacterium tumefaciens,4,3,At43.1,tig00000004_polypolish,223582,223583,1
1361,Agrobacterium tumefaciens,4,3,At43.1,tig00000004_polypolish,223726,229503,5777
1362,Agrobacterium tumefaciens,4,3,At43.1,tig00000005_polypolish,0,31114,31114
1363,Agrobacterium tumefaciens,4,4,At44.1,tig00000001_polypolish,1,2164,2163
1364,Agrobacterium tumefaciens,4,4,At44.1,tig00000001_polypolish,2352,2353,1
1365,Agrobacterium tumefaciens,4,4,At44.1,tig00000001_polypolish,2362,2363,1
1366,Agrobacterium tumefaciens,4,4,At44.1,tig00000001_polypolish,2510,2511,1
1367,Agrobacterium tumefaciens,4,4,At44.1,tig00000001_polypolish,2736,2737,1
1368,Agrobacterium tumefaciens,4,4,At44.1,tig00000001_polypolish,2759,2761,2
1369,Agrobacterium tumefaciens,4,4,At44.1,tig00000001_polypolish,4415,4416,1
1370,Agrobacterium tumefaciens,4,4,At44.1,tig00000001_polypolish,4909,4910,1
1371,Agrobacterium tumefaciens,4,4,At44.1,tig00000001_polypolish,8450,8451,1
1372,Agrobacterium tumefaciens,4,4,At44.1,tig00000001_polypolish,1939269,1939279,10
1373,Agrobacterium tumefaciens,4,4,At44.1,tig00000001_polypolish,2174372,2174373,1
1374,Agrobacterium tumefaciens,4,4,At44.1,tig00000001_polypolish,2997836,2999962,2126
1375,Agrobacterium tumefaciens,4,4,At44.1,tig00000003_polypolish,0,2541,2541
1376,Agrobacterium tumefaciens,4,4,At44.1,tig00000003_polypolish,2658,2660,2
1377,Agrobacterium tumefaciens,4,4,At44.1,tig00000003_polypolish,2753,2754,1
1378,Agrobacterium tumefaciens,4,4,At44.1,tig00000003_polypolish,2767,2768,1
1379,Agrobacterium tumefaciens,4,4,At44.1,tig00000003_polypolish,2775,2776,1
1380,Agrobacterium tumefaciens,4,4,At44.1,tig00000003_polypolish,2817,2819,2
1381,Agrobacterium tumefaciens,4,4,At44.1,tig00000003_polypolish,2849,2850,1
1382,Agrobacterium tumefaciens,4,4,At44.1,tig00000003_polypolish,2930,2931,1
1383,Agrobacterium tumefaciens,4,4,At44.1,tig00000003_polypolish,2996,2997,1
1384,Agrobacterium tumefaciens,4,4,At44.1,tig00000003_polypolish,4692,4693,1
1385,Agrobacterium tumefaciens,4,4,At44.1,tig00000003_polypolish,5325,5327,2
1386,Agrobacterium tumefaciens,4,4,At44.1,tig00000003_polypolish,38338,77813,39475
1387,Agrobacterium tumefaciens,4,4,At44.1,tig00000003_polypolish,77991,77992,1
1388,Agrobacterium tumefaciens,4,4,At44.1,tig00000003_polypolish,77999,78000,1
1389,Agrobacterium tumefaciens,4,4,At44.1,tig00000003_polypolish,78020,78022,2
1390,Agrobacterium tumefaciens,4,4,At44.1,tig00000003_polypolish,78024,78026,2
1391,Agrobacterium tumefaciens,4,4,At44.1,tig00000003_polypolish,78386,78387,1
1392,Agrobacterium tumefaciens,4,4,At44.1,tig00000003_polypolish,78392,78393,1
1393,Agrobacterium tumefaciens,4,4,At44.1,tig00000003_polypolish,78394,78397,3
1394,Agrobacterium tumefaciens,4,4,At44.1,tig00000003_polypolish,78404,78405,1
1395,Agrobacterium tumefaciens,4,4,At44.1,tig00000003_polypolish,78408,78409,1
1396,Agrobacterium tumefaciens,4,4,At44.1,tig00000003_polypolish,78503,78504,1
1397,Agrobacterium tumefaciens,4,4,At44.1,tig00000003_polypolish,78533,78535,2
1398,Agrobacterium tumefaciens,4,4,At44.1,tig00000003_polypolish,78541,78542,1
1399,Agrobacterium tumefaciens,4,4,At44.1,tig00000003_polypolish,78567,78568,1
1400,Agrobacterium tumefaciens,4,4,At44.1,tig00000003_polypolish,78570,78571,1
1401,Agrobacterium tumefaciens,4,4,At44.1,tig00000003_polypolish,78575,78576,1
1402,Agrobacterium tumefaciens,4,4,At44.1,tig00000003_polypolish,78652,78653,1
1403,Agrobacterium tumefaciens,4,4,At44.1,tig00000003_polypolish,78814,78815,1
1404,Agrobacterium tumefaciens,4,4,At44.1,tig00000003_polypolish,78875,78876,1
1405,Agrobacterium tumefaciens,4,4,At44.1,tig00000003_polypolish,79027,79028,1
1406,Agrobacterium tumefaciens,4,4,At44.1,tig00000003_polypolish,139204,139205,1
1407,Agrobacterium tumefaciens,4,4,At44.1,tig00000003_polypolish,212549,212550,1
1408,Agrobacterium tumefaciens,4,4,At44.1,tig00000003_polypolish,212874,213991,1117
1409,Agrobacterium tumefaciens,4,4,At44.1,tig00000004_polypolish,0,1712,1712
1410,Agrobacterium tumefaciens,4,4,At44.1,tig00000004_polypolish,42984,42985,1
1411,Agrobacterium tumefaciens,4,4,At44.1,tig00000004_polypolish,42997,42998,1
1412,Agrobacterium tumefaciens,4,4,At44.1,tig00000004_polypolish,43010,43012,2
1413,Agrobacterium tumefaciens,4,4,At44.1,tig00000004_polypolish,150769,150771,2
1414,Agrobacterium tumefaciens,4,4,At44.1,tig00000004_polypolish,151591,151592,1
1415,Agrobacterium tumefaciens,4,4,At44.1,tig00000004_polypolish,151642,151643,1
1416,Agrobacterium tumefaciens,4,4,At44.1,tig00000004_polypolish,152159,152169,10
1417,Agrobacterium tumefaciens,4,4,At44.1,tig00000004_polypolish,152256,152259,3
1418,Agrobacterium tumefaciens,4,4,At44.1,tig00000004_polypolish,152264,152266,2
1419,Agrobacterium tumefaciens,4,4,At44.1,tig00000004_polypolish,152276,152278,2
1420,Agrobacterium tumefaciens,4,4,At44.1,tig00000004_polypolish,152300,170558,18258
1421,Agrobacterium tumefaciens,4,4,At44.1,tig00000004_polypolish,221890,221891,1
1422,Agrobacterium tumefaciens,4,4,At44.1,tig00000004_polypolish,221988,221989,1
1423,Agrobacterium tumefaciens,4,4,At44.1,tig00000004_polypolish,223454,223455,1
1424,Agrobacterium tumefaciens,4,4,At44.1,tig00000004_polypolish,223534,223535,1
1425,Agrobacterium tumefaciens,4,4,At44.1,tig00000004_polypolish,223966,223967,1
1426,Agrobacterium tumefaciens,4,4,At44.1,tig00000004_polypolish,223989,223990,1
1427,Agrobacterium tumefaciens,4,4,At44.1,tig00000004_polypolish,224328,224329,1
1428,Agrobacterium tumefaciens,4,4,At44.1,tig00000004_polypolish,224356,224357,1
1429,Agrobacterium tumefaciens,4,4,At44.1,tig00000004_polypolish,224415,224416,1
1430,Agrobacterium tumefaciens,4,4,At44.1,tig00000004_polypolish,224640,224641,1
1431,Agrobacterium tumefaciens,4,4,At44.1,tig00000004_polypolish,224868,224869,1
1432,Agrobacterium tumefaciens,4,4,At44.1,tig00000004_polypolish,224997,224998,1
1433,Agrobacterium tumefaciens,4,4,At44.1,tig00000004_polypolish,225091,225092,1
1434,Agrobacterium tumefaciens,4,4,At44.1,tig00000004_polypolish,225341,225342,1
1435,Agrobacterium tumefaciens,4,4,At44.1,tig00000004_polypolish,226054,226055,1
1436,Agrobacterium tumefaciens,4,4,At44.1,tig00000004_polypolish,226109,226110,1
1437,Agrobacterium tumefaciens,4,4,At44.1,tig00000004_polypolish,226338,226339,1
1438,Agrobacterium tumefaciens,4,4,At44.1,tig00000004_polypolish,226395,226396,1
1439,Agrobacterium tumefaciens,4,4,At44.1,tig00000004_polypolish,226412,226413,1
1440,Agrobacterium tumefaciens,4,4,At44.1,tig00000004_polypolish,226436,226437,1
1441,Agrobacterium tumefaciens,4,4,At44.1,tig00000004_polypolish,226478,226479,1
1442,Agrobacterium tumefaciens,4,4,At44.1,tig00000004_polypolish,226626,226627,1
1443,Agrobacterium tumefaciens,4,4,At44.1,tig00000004_polypolish,226702,226703,1
1444,Agrobacterium tumefaciens,4,4,At44.1,tig00000004_polypolish,226786,226787,1
1445,Agrobacterium tumefaciens,4,4,At44.1,tig00000004_polypolish,226997,226998,1
1446,Agrobacterium tumefaciens,4,4,At44.1,tig00000004_polypolish,227281,227282,1
1447,Agrobacterium tumefaciens,4,4,At44.1,tig00000004_polypolish,227300,229503,2203
1448,Agrobacterium tumefaciens,4,4,At44.1,tig00000005_polypolish,253,254,1
1449,Agrobacterium tumefaciens,4,4,At44.1,tig00000005_polypolish,600,601,1
1450,Agrobacterium tumefaciens,4,4,At44.1,tig00000005_polypolish,625,626,1
1451,Agrobacterium tumefaciens,4,4,At44.1,tig00000005_polypolish,657,658,1
1452,Agrobacterium tumefaciens,4,4,At44.1,tig00000005_polypolish,666,667,1
1453,Agrobacterium tumefaciens,4,4,At44.1,tig00000005_polypolish,680,681,1
1454,Agrobacterium tumefaciens,4,4,At44.1,tig00000005_polypolish,803,804,1
1455,Agrobacterium tumefaciens,4,4,At44.1,tig00000005_polypolish,1072,1073,1
1456,Agrobacterium tumefaciens,4,4,At44.1,tig00000005_polypolish,1729,1730,1
1457,Agrobacterium tumefaciens,4,4,At44.1,tig00000005_polypolish,1887,1888,1
1458,Agrobacterium tumefaciens,4,4,At44.1,tig00000005_polypolish,2387,2388,1
1459,Agrobacterium tumefaciens,4,4,At44.1,tig00000005_polypolish,3510,3511,1
1460,Agrobacterium tumefaciens,4,4,At44.1,tig00000005_polypolish,3771,3772,1
1461,Agrobacterium tumefaciens,4,4,At44.1,tig00000005_polypolish,4354,4355,1
1462,Agrobacterium tumefaciens,4,4,At44.1,tig00000005_polypolish,4518,4519,1
1463,Agrobacterium tumefaciens,4,4,At44.1,tig00000005_polypolish,5208,5209,1
1464,Agrobacterium tumefaciens,4,4,At44.1,tig00000005_polypolish,5647,5648,1
1465,Agrobacterium tumefaciens,4,4,At44.1,tig00000005_polypolish,5818,5819,1
1466,Agrobacterium tumefaciens,4,4,At44.1,tig00000005_polypolish,5842,5843,1
1467,Agrobacterium tumefaciens,4,4,At44.1,tig00000005_polypolish,5924,5925,1
1468,Agrobacterium tumefaciens,4,4,At44.1,tig00000005_polypolish,6409,6410,1
1469,Agrobacterium tumefaciens,4,4,At44.1,tig00000005_polypolish,9075,9076,1
1470,Agrobacterium tumefaciens,4,4,At44.1,tig00000005_polypolish,9722,9723,1
1471,Agrobacterium tumefaciens,4,4,At44.1,tig00000005_polypolish,10828,10829,1
1472,Agrobacterium tumefaciens,4,4,At44.1,tig00000005_polypolish,11114,11115,1
1473,Agrobacterium tumefaciens,4,4,At44.1,tig00000005_polypolish,11996,11997,1
1474,Agrobacterium tumefaciens,4,4,At44.1,tig00000005_polypolish,12051,12052,1
1475,Agrobacterium tumefaciens,4,4,At44.1,tig00000005_polypolish,12256,12257,1
1476,Agrobacterium tumefaciens,4,4,At44.1,tig00000005_polypolish,12319,12320,1
1477,Agrobacterium tumefaciens,4,4,At44.1,tig00000005_polypolish,13591,13592,1
1478,Agrobacterium tumefaciens,4,4,At44.1,tig00000005_polypolish,13778,13779,1
1479,Agrobacterium tumefaciens,4,4,At44.1,tig00000005_polypolish,14086,14087,1
1480,Agrobacterium tumefaciens,4,4,At44.1,tig00000005_polypolish,14160,14161,1
1481,Agrobacterium tumefaciens,4,4,At44.1,tig00000005_polypolish,15258,15259,1
1482,Agrobacterium tumefaciens,4,4,At44.1,tig00000005_polypolish,15544,15545,1
1483,Agrobacterium tumefaciens,4,4,At44.1,tig00000005_polypolish,15605,15606,1
1484,Agrobacterium tumefaciens,4,4,At44.1,tig00000005_polypolish,15778,15779,1
1485,Agrobacterium tumefaciens,4,4,At44.1,tig00000005_polypolish,15840,15841,1
1486,Agrobacterium tumefaciens,4,4,At44.1,tig00000005_polypolish,15845,15846,1
1487,Agrobacterium tumefaciens,4,4,At44.1,tig00000005_polypolish,15964,15965,1
1488,Agrobacterium tumefaciens,4,4,At44.1,tig00000005_polypolish,16030,16031,1
1489,Agrobacterium tumefaciens,4,4,At44.1,tig00000005_polypolish,16049,16050,1
1490,Agrobacterium tumefaciens,4,4,At44.1,tig00000005_polypolish,16168,21420,5252
1491,Agrobacterium tumefaciens,4,4,At44.1,tig00000005_polypolish,21516,21517,1
1492,Agrobacterium tumefaciens,4,4,At44.1,tig00000005_polypolish,21579,21581,2
1493,Agrobacterium tumefaciens,4,4,At44.1,tig00000005_polypolish,21619,21620,1
1494,Agrobacterium tumefaciens,4,4,At44.1,tig00000005_polypolish,21626,21627,1
1495,Agrobacterium tumefaciens,4,4,At44.1,tig00000005_polypolish,21669,21670,1
1496,Agrobacterium tumefaciens,4,4,At44.1,tig00000005_polypolish,21724,21725,1
1497,Agrobacterium tumefaciens,4,4,At44.1,tig00000005_polypolish,21773,21774,1
1498,Agrobacterium tumefaciens,4,4,At44.1,tig00000005_polypolish,21876,21877,1
1499,Agrobacterium tumefaciens,4,4,At44.1,tig00000005_polypolish,21887,21888,1
1500,Agrobacterium tumefaciens,4,4,At44.1,tig00000005_polypolish,22009,22010,1
1501,Agrobacterium tumefaciens,4,4,At44.1,tig00000005_polypolish,22222,22223,1
1502,Agrobacterium tumefaciens,4,4,At44.1,tig00000005_polypolish,22424,22425,1
1503,Agrobacterium tumefaciens,4,4,At44.1,tig00000005_polypolish,22458,22459,1
1504,Agrobacterium tumefaciens,4,4,At44.1,tig00000005_polypolish,22487,22488,1
1505,Agrobacterium tumefaciens,4,4,At44.1,tig00000005_polypolish,22611,22612,1
1506,Agrobacterium tumefaciens,4,4,At44.1,tig00000005_polypolish,22657,22658,1
1507,Agrobacterium tumefaciens,4,4,At44.1,tig00000005_polypolish,22667,22668,1
1508,Agrobacterium tumefaciens,4,4,At44.1,tig00000005_polypolish,22782,22783,1
1509,Agrobacterium tumefaciens,4,4,At44.1,tig00000005_polypolish,22805,22806,1
1510,Agrobacterium tumefaciens,4,4,At44.1,tig00000005_polypolish,22940,22941,1
1511,Agrobacterium tumefaciens,4,4,At44.1,tig00000005_polypolish,23074,23075,1
1512,Agrobacterium tumefaciens,4,4,At44.1,tig00000005_polypolish,23126,23127,1
1513,Agrobacterium tumefaciens,4,4,At44.1,tig00000005_polypolish,23165,23166,1
1514,Agrobacterium tumefaciens,4,4,At44.1,tig00000005_polypolish,23572,23573,1
1515,Agrobacterium tumefaciens,4,4,At44.1,tig00000005_polypolish,23819,23820,1
1516,Agrobacterium tumefaciens,4,4,At44.1,tig00000005_polypolish,23860,23861,1
1517,Agrobacterium tumefaciens,4,4,At44.1,tig00000005_polypolish,24017,24018,1
1518,Agrobacterium tumefaciens,4,4,At44.1,tig00000005_polypolish,24363,24364,1
1519,Agrobacterium tumefaciens,4,4,At44.1,tig00000005_polypolish,24451,24452,1
1520,Agrobacterium tumefaciens,4,4,At44.1,tig00000005_polypolish,24481,24482,1
1521,Agrobacterium tumefaciens,4,4,At44.1,tig00000005_polypolish,24518,24519,1
1522,Agrobacterium tumefaciens,4,4,At44.1,tig00000005_polypolish,24623,24624,1
1523,Agrobacterium tumefaciens,4,4,At44.1,tig00000005_polypolish,24952,24953,1
1524,Agrobacterium tumefaciens,4,4,At44.1,tig00000005_polypolish,25050,25051,1
1525,Agrobacterium tumefaciens,4,4,At44.1,tig00000005_polypolish,25055,25056,1
1526,Agrobacterium tumefaciens,4,4,At44.1,tig00000005_polypolish,25063,25064,1
1527,Agrobacterium tumefaciens,4,4,At44.1,tig00000005_polypolish,25074,25075,1
1528,Agrobacterium tumefaciens,4,4,At44.1,tig00000005_polypolish,25078,25079,1
1529,Agrobacterium tumefaciens,4,4,At44.1,tig00000005_polypolish,25239,25240,1
1530,Agrobacterium tumefaciens,4,4,At44.1,tig00000005_polypolish,25274,25275,1
1531,Agrobacterium tumefaciens,4,4,At44.1,tig00000005_polypolish,25366,25367,1
1532,Agrobacterium tumefaciens,4,4,At44.1,tig00000005_polypolish,25813,25814,1
1533,Agrobacterium tumefaciens,4,4,At44.1,tig00000005_polypolish,26447,26448,1
1534,Agrobacterium tumefaciens,4,4,At44.1,tig00000005_polypolish,27156,27157,1
1535,Agrobacterium tumefaciens,4,4,At44.1,tig00000005_polypolish,28966,28967,1
1536,Agrobacterium tumefaciens,4,4,At44.1,tig00000005_polypolish,29121,29122,1
1537,Agrobacterium tumefaciens,4,4,At44.1,tig00000005_polypolish,29502,29503,1
1538,Agrobacterium tumefaciens,4,4,At44.1,tig00000005_polypolish,29849,29850,1
1539,Agrobacterium tumefaciens,4,4,At44.1,tig00000005_polypolish,29874,29875,1
1540,Agrobacterium tumefaciens,4,4,At44.1,tig00000005_polypolish,29906,29907,1
1541,Agrobacterium tumefaciens,4,4,At44.1,tig00000005_polypolish,29915,29916,1
1542,Agrobacterium tumefaciens,4,4,At44.1,tig00000005_polypolish,29929,29930,1
1543,Agrobacterium tumefaciens,4,4,At44.1,tig00000005_polypolish,30052,30053,1
1544,Agrobacterium tumefaciens,4,4,At44.1,tig00000005_polypolish,30212,30213,1
1545,Agrobacterium tumefaciens,4,4,At44.1,tig00000005_polypolish,30313,30314,1
1546,Agrobacterium tumefaciens,4,4,At44.1,tig00000005_polypolish,30321,30322,1
1547,Agrobacterium tumefaciens,4,4,At44.1,tig00000005_polypolish,30607,30608,1
1548,Agrobacterium tumefaciens,4,4,At44.1,tig00000005_polypolish,30713,30714,1
1549,Agrobacterium tumefaciens,4,4,At44.1,tig00000005_polypolish,30884,30885,1
1550,Agrobacterium tumefaciens,4,4,At44.1,tig00000005_polypolish,30978,30979,1
1551,Agrobacterium tumefaciens,4,5,At45.1,tig00000001_polypolish,1,1270,1269
1552,Agrobacterium tumefaciens,4,5,At45.1,tig00000001_polypolish,66722,66723,1
1553,Agrobacterium tumefaciens,4,5,At45.1,tig00000001_polypolish,102574,102575,1
1554,Agrobacterium tumefaciens,4,5,At45.1,tig00000001_polypolish,159903,159904,1
1555,Agrobacterium tumefaciens,4,5,At45.1,tig00000001_polypolish,375512,375513,1
1556,Agrobacterium tumefaciens,4,5,At45.1,tig00000001_polypolish,425600,425601,1
1557,Agrobacterium tumefaciens,4,5,At45.1,tig00000001_polypolish,478885,478886,1
1558,Agrobacterium tumefaciens,4,5,At45.1,tig00000001_polypolish,581180,581181,1
1559,Agrobacterium tumefaciens,4,5,At45.1,tig00000001_polypolish,634214,634215,1
1560,Agrobacterium tumefaciens,4,5,At45.1,tig00000001_polypolish,647235,647236,1
1561,Agrobacterium tumefaciens,4,5,At45.1,tig00000001_polypolish,746598,746599,1
1562,Agrobacterium tumefaciens,4,5,At45.1,tig00000001_polypolish,799411,799412,1
1563,Agrobacterium tumefaciens,4,5,At45.1,tig00000001_polypolish,812241,812242,1
1564,Agrobacterium tumefaciens,4,5,At45.1,tig00000001_polypolish,856108,856109,1
1565,Agrobacterium tumefaciens,4,5,At45.1,tig00000001_polypolish,1195469,1196349,880
1566,Agrobacterium tumefaciens,4,5,At45.1,tig00000001_polypolish,1238918,1238919,1
1567,Agrobacterium tumefaciens,4,5,At45.1,tig00000001_polypolish,1701434,1701435,1
1568,Agrobacterium tumefaciens,4,5,At45.1,tig00000001_polypolish,1922139,1922140,1
1569,Agrobacterium tumefaciens,4,5,At45.1,tig00000001_polypolish,1928706,1928707,1
1570,Agrobacterium tumefaciens,4,5,At45.1,tig00000001_polypolish,2211002,2211003,1
1571,Agrobacterium tumefaciens,4,5,At45.1,tig00000001_polypolish,2994640,2994641,1
1572,Agrobacterium tumefaciens,4,5,At45.1,tig00000001_polypolish,2994728,2994729,1
1573,Agrobacterium tumefaciens,4,5,At45.1,tig00000001_polypolish,2994791,2994792,1
1574,Agrobacterium tumefaciens,4,5,At45.1,tig00000001_polypolish,2994961,2994962,1
1575,Agrobacterium tumefaciens,4,5,At45.1,tig00000001_polypolish,2995308,2995309,1
1576,Agrobacterium tumefaciens,4,5,At45.1,tig00000001_polypolish,2995556,2995557,1
1577,Agrobacterium tumefaciens,4,5,At45.1,tig00000001_polypolish,2995665,2995666,1
1578,Agrobacterium tumefaciens,4,5,At45.1,tig00000001_polypolish,2995776,2995777,1
1579,Agrobacterium tumefaciens,4,5,At45.1,tig00000001_polypolish,2995796,2995797,1
1580,Agrobacterium tumefaciens,4,5,At45.1,tig00000001_polypolish,2995880,2995881,1
1581,Agrobacterium tumefaciens,4,5,At45.1,tig00000001_polypolish,2996480,2996482,2
1582,Agrobacterium tumefaciens,4,5,At45.1,tig00000001_polypolish,2996594,2999962,3368
1583,Agrobacterium tumefaciens,4,5,At45.1,tig00000002_polypolish,486480,486481,1
1584,Agrobacterium tumefaciens,4,5,At45.1,tig00000003_polypolish,0,5005,5005
1585,Agrobacterium tumefaciens,4,5,At45.1,tig00000003_polypolish,5514,5515,1
1586,Agrobacterium tumefaciens,4,5,At45.1,tig00000003_polypolish,6739,6742,3
1587,Agrobacterium tumefaciens,4,5,At45.1,tig00000003_polypolish,25130,25131,1
1588,Agrobacterium tumefaciens,4,5,At45.1,tig00000003_polypolish,61448,61449,1
1589,Agrobacterium tumefaciens,4,5,At45.1,tig00000003_polypolish,70341,70342,1
1590,Agrobacterium tumefaciens,4,5,At45.1,tig00000003_polypolish,87454,87455,1
1591,Agrobacterium tumefaciens,4,5,At45.1,tig00000003_polypolish,93908,93909,1
1592,Agrobacterium tumefaciens,4,5,At45.1,tig00000003_polypolish,166237,166238,1
1593,Agrobacterium tumefaciens,4,5,At45.1,tig00000003_polypolish,181534,181535,1
1594,Agrobacterium tumefaciens,4,5,At45.1,tig00000003_polypolish,208870,208872,2
1595,Agrobacterium tumefaciens,4,5,At45.1,tig00000003_polypolish,209267,209268,1
1596,Agrobacterium tumefaciens,4,5,At45.1,tig00000003_polypolish,209386,209387,1
1597,Agrobacterium tumefaciens,4,5,At45.1,tig00000003_polypolish,209658,209659,1
1598,Agrobacterium tumefaciens,4,5,At45.1,tig00000003_polypolish,210047,213991,3944
1599,Agrobacterium tumefaciens,4,5,At45.1,tig00000004_polypolish,0,2003,2003
1600,Agrobacterium tumefaciens,4,5,At45.1,tig00000004_polypolish,2167,2168,1
1601,Agrobacterium tumefaciens,4,5,At45.1,tig00000004_polypolish,2371,2372,1
1602,Agrobacterium tumefaciens,4,5,At45.1,tig00000004_polypolish,2540,2541,1
1603,Agrobacterium tumefaciens,4,5,At45.1,tig00000004_polypolish,2817,2818,1
1604,Agrobacterium tumefaciens,4,5,At45.1,tig00000004_polypolish,2829,2830,1
1605,Agrobacterium tumefaciens,4,5,At45.1,tig00000004_polypolish,3541,3542,1
1606,Agrobacterium tumefaciens,4,5,At45.1,tig00000004_polypolish,4633,4634,1
1607,Agrobacterium tumefaciens,4,5,At45.1,tig00000004_polypolish,9474,9475,1
1608,Agrobacterium tumefaciens,4,5,At45.1,tig00000004_polypolish,28381,28382,1
1609,Agrobacterium tumefaciens,4,5,At45.1,tig00000004_polypolish,28954,28955,1
1610,Agrobacterium tumefaciens,4,5,At45.1,tig00000004_polypolish,29150,29151,1
1611,Agrobacterium tumefaciens,4,5,At45.1,tig00000004_polypolish,30326,30327,1
1612,Agrobacterium tumefaciens,4,5,At45.1,tig00000004_polypolish,30860,30861,1
1613,Agrobacterium tumefaciens,4,5,At45.1,tig00000004_polypolish,34084,34085,1
1614,Agrobacterium tumefaciens,4,5,At45.1,tig00000004_polypolish,34402,34403,1
1615,Agrobacterium tumefaciens,4,5,At45.1,tig00000004_polypolish,36904,36905,1
1616,Agrobacterium tumefaciens,4,5,At45.1,tig00000004_polypolish,37448,37449,1
1617,Agrobacterium tumefaciens,4,5,At45.1,tig00000004_polypolish,39031,39032,1
1618,Agrobacterium tumefaciens,4,5,At45.1,tig00000004_polypolish,49226,49227,1
1619,Agrobacterium tumefaciens,4,5,At45.1,tig00000004_polypolish,115396,115397,1
1620,Agrobacterium tumefaciens,4,5,At45.1,tig00000004_polypolish,119130,119131,1
1621,Agrobacterium tumefaciens,4,5,At45.1,tig00000004_polypolish,128621,128622,1
1622,Agrobacterium tumefaciens,4,5,At45.1,tig00000004_polypolish,160830,160831,1
1623,Agrobacterium tumefaciens,4,5,At45.1,tig00000004_polypolish,177706,177707,1
1624,Agrobacterium tumefaciens,4,5,At45.1,tig00000004_polypolish,222030,222031,1
1625,Agrobacterium tumefaciens,4,5,At45.1,tig00000004_polypolish,223209,229503,6294
1626,Agrobacterium tumefaciens,4,5,At45.1,tig00000005_polypolish,0,550,550
1627,Agrobacterium tumefaciens,4,5,At45.1,tig00000005_polypolish,625,626,1
1628,Agrobacterium tumefaciens,4,5,At45.1,tig00000005_polypolish,828,829,1
1629,Agrobacterium tumefaciens,4,5,At45.1,tig00000005_polypolish,1009,1010,1
1630,Agrobacterium tumefaciens,4,5,At45.1,tig00000005_polypolish,1024,1026,2
1631,Agrobacterium tumefaciens,4,5,At45.1,tig00000005_polypolish,1040,1041,1
1632,Agrobacterium tumefaciens,4,5,At45.1,tig00000005_polypolish,1251,1252,1
1633,Agrobacterium tumefaciens,4,5,At45.1,tig00000005_polypolish,1358,1359,1
1634,Agrobacterium tumefaciens,4,5,At45.1,tig00000005_polypolish,1448,1449,1
1635,Agrobacterium tumefaciens,4,5,At45.1,tig00000005_polypolish,1527,1529,2
1636,Agrobacterium tumefaciens,4,5,At45.1,tig00000005_polypolish,1679,1680,1
1637,Agrobacterium tumefaciens,4,5,At45.1,tig00000005_polypolish,1869,1870,1
1638,Agrobacterium tumefaciens,4,5,At45.1,tig00000005_polypolish,1885,1886,1
1639,Agrobacterium tumefaciens,4,5,At45.1,tig00000005_polypolish,1979,1980,1
1640,Agrobacterium tumefaciens,4,5,At45.1,tig00000005_polypolish,2361,2362,1
1641,Agrobacterium tumefaciens,4,5,At45.1,tig00000005_polypolish,2685,2686,1
1642,Agrobacterium tumefaciens,4,5,At45.1,tig00000005_polypolish,2740,2741,1
1643,Agrobacterium tumefaciens,4,5,At45.1,tig00000005_polypolish,2795,2797,2
1644,Agrobacterium tumefaciens,4,5,At45.1,tig00000005_polypolish,2991,2992,1
1645,Agrobacterium tumefaciens,4,5,At45.1,tig00000005_polypolish,3103,3104,1
1646,Agrobacterium tumefaciens,4,5,At45.1,tig00000005_polypolish,3122,3123,1
1647,Agrobacterium tumefaciens,4,5,At45.1,tig00000005_polypolish,3473,3474,1
1648,Agrobacterium tumefaciens,4,5,At45.1,tig00000005_polypolish,3510,3511,1
1649,Agrobacterium tumefaciens,4,5,At45.1,tig00000005_polypolish,3528,3529,1
1650,Agrobacterium tumefaciens,4,5,At45.1,tig00000005_polypolish,3906,3907,1
1651,Agrobacterium tumefaciens,4,5,At45.1,tig00000005_polypolish,4017,4018,1
1652,Agrobacterium tumefaciens,4,5,At45.1,tig00000005_polypolish,4062,4063,1
1653,Agrobacterium tumefaciens,4,5,At45.1,tig00000005_polypolish,4159,4160,1
1654,Agrobacterium tumefaciens,4,5,At45.1,tig00000005_polypolish,4426,4427,1
1655,Agrobacterium tumefaciens,4,5,At45.1,tig00000005_polypolish,4539,4540,1
1656,Agrobacterium tumefaciens,4,5,At45.1,tig00000005_polypolish,4543,4544,1
1657,Agrobacterium tumefaciens,4,5,At45.1,tig00000005_polypolish,4654,4655,1
1658,Agrobacterium tumefaciens,4,5,At45.1,tig00000005_polypolish,4769,4770,1
1659,Agrobacterium tumefaciens,4,5,At45.1,tig00000005_polypolish,5108,5109,1
1660,Agrobacterium tumefaciens,4,5,At45.1,tig00000005_polypolish,5530,5531,1
1661,Agrobacterium tumefaciens,4,5,At45.1,tig00000005_polypolish,5754,5756,2
1662,Agrobacterium tumefaciens,4,5,At45.1,tig00000005_polypolish,5941,5942,1
1663,Agrobacterium tumefaciens,4,5,At45.1,tig00000005_polypolish,6135,6136,1
1664,Agrobacterium tumefaciens,4,5,At45.1,tig00000005_polypolish,6235,6236,1
1665,Agrobacterium tumefaciens,4,5,At45.1,tig00000005_polypolish,6514,6515,1
1666,Agrobacterium tumefaciens,4,5,At45.1,tig00000005_polypolish,7355,7356,1
1667,Agrobacterium tumefaciens,4,5,At45.1,tig00000005_polypolish,7487,7489,2
1668,Agrobacterium tumefaciens,4,5,At45.1,tig00000005_polypolish,7555,7558,3
1669,Agrobacterium tumefaciens,4,5,At45.1,tig00000005_polypolish,7591,7592,1
1670,Agrobacterium tumefaciens,4,5,At45.1,tig00000005_polypolish,8124,8125,1
1671,Agrobacterium tumefaciens,4,5,At45.1,tig00000005_polypolish,8221,8222,1
1672,Agrobacterium tumefaciens,4,5,At45.1,tig00000005_polypolish,9217,9218,1
1673,Agrobacterium tumefaciens,4,5,At45.1,tig00000005_polypolish,10055,10056,1
1674,Agrobacterium tumefaciens,4,5,At45.1,tig00000005_polypolish,10214,10215,1
1675,Agrobacterium tumefaciens,4,5,At45.1,tig00000005_polypolish,10852,10853,1
1676,Agrobacterium tumefaciens,4,5,At45.1,tig00000005_polypolish,11107,11108,1
1677,Agrobacterium tumefaciens,4,5,At45.1,tig00000005_polypolish,11528,11529,1
1678,Agrobacterium tumefaciens,4,5,At45.1,tig00000005_polypolish,11588,11589,1
1679,Agrobacterium tumefaciens,4,5,At45.1,tig00000005_polypolish,11731,11732,1
1680,Agrobacterium tumefaciens,4,5,At45.1,tig00000005_polypolish,11918,11919,1
1681,Agrobacterium tumefaciens,4,5,At45.1,tig00000005_polypolish,12040,12041,1
1682,Agrobacterium tumefaciens,4,5,At45.1,tig00000005_polypolish,12059,12060,1
1683,Agrobacterium tumefaciens,4,5,At45.1,tig00000005_polypolish,12235,12236,1
1684,Agrobacterium tumefaciens,4,5,At45.1,tig00000005_polypolish,12514,12515,1
1685,Agrobacterium tumefaciens,4,5,At45.1,tig00000005_polypolish,12529,12530,1
1686,Agrobacterium tumefaciens,4,5,At45.1,tig00000005_polypolish,12565,12566,1
1687,Agrobacterium tumefaciens,4,5,At45.1,tig00000005_polypolish,12808,12809,1
1688,Agrobacterium tumefaciens,4,5,At45.1,tig00000005_polypolish,12942,12943,1
1689,Agrobacterium tumefaciens,4,5,At45.1,tig00000005_polypolish,12946,12947,1
1690,Agrobacterium tumefaciens,4,5,At45.1,tig00000005_polypolish,13040,13041,1
1691,Agrobacterium tumefaciens,4,5,At45.1,tig00000005_polypolish,13255,13256,1
1692,Agrobacterium tumefaciens,4,5,At45.1,tig00000005_polypolish,13481,13482,1
1693,Agrobacterium tumefaciens,4,5,At45.1,tig00000005_polypolish,13507,13508,1
1694,Agrobacterium tumefaciens,4,5,At45.1,tig00000005_polypolish,13580,13581,1
1695,Agrobacterium tumefaciens,4,5,At45.1,tig00000005_polypolish,13604,13605,1
1696,Agrobacterium tumefaciens,4,5,At45.1,tig00000005_polypolish,13654,19646,5992
1697,Agrobacterium tumefaciens,4,5,At45.1,tig00000005_polypolish,19769,19770,1
1698,Agrobacterium tumefaciens,4,5,At45.1,tig00000005_polypolish,19782,19783,1
1699,Agrobacterium tumefaciens,4,5,At45.1,tig00000005_polypolish,19836,19837,1
1700,Agrobacterium tumefaciens,4,5,At45.1,tig00000005_polypolish,19986,19987,1
1701,Agrobacterium tumefaciens,4,5,At45.1,tig00000005_polypolish,20000,20001,1
1702,Agrobacterium tumefaciens,4,5,At45.1,tig00000005_polypolish,20142,20143,1
1703,Agrobacterium tumefaciens,4,5,At45.1,tig00000005_polypolish,20216,20217,1
1704,Agrobacterium tumefaciens,4,5,At45.1,tig00000005_polypolish,20512,20513,1
1705,Agrobacterium tumefaciens,4,5,At45.1,tig00000005_polypolish,20587,20588,1
1706,Agrobacterium tumefaciens,4,5,At45.1,tig00000005_polypolish,21422,21423,1
1707,Agrobacterium tumefaciens,4,5,At45.1,tig00000005_polypolish,21468,21469,1
1708,Agrobacterium tumefaciens,4,5,At45.1,tig00000005_polypolish,21930,21931,1
1709,Agrobacterium tumefaciens,4,5,At45.1,tig00000005_polypolish,22316,22317,1
1710,Agrobacterium tumefaciens,4,5,At45.1,tig00000005_polypolish,22424,22425,1
1711,Agrobacterium tumefaciens,4,5,At45.1,tig00000005_polypolish,22466,22467,1
1712,Agrobacterium tumefaciens,4,5,At45.1,tig00000005_polypolish,22733,22734,1
1713,Agrobacterium tumefaciens,4,5,At45.1,tig00000005_polypolish,22789,22790,1
1714,Agrobacterium tumefaciens,4,5,At45.1,tig00000005_polypolish,22883,22884,1
1715,Agrobacterium tumefaciens,4,5,At45.1,tig00000005_polypolish,22895,22896,1
1716,Agrobacterium tumefaciens,4,5,At45.1,tig00000005_polypolish,23305,23306,1
1717,Agrobacterium tumefaciens,4,5,At45.1,tig00000005_polypolish,23487,23488,1
1718,Agrobacterium tumefaciens,4,5,At45.1,tig00000005_polypolish,23519,23520,1
1719,Agrobacterium tumefaciens,4,5,At45.1,tig00000005_polypolish,23539,23541,2
1720,Agrobacterium tumefaciens,4,5,At45.1,tig00000005_polypolish,23636,23637,1
1721,Agrobacterium tumefaciens,4,5,At45.1,tig00000005_polypolish,23643,23644,1
1722,Agrobacterium tumefaciens,4,5,At45.1,tig00000005_polypolish,23732,23733,1
1723,Agrobacterium tumefaciens,4,5,At45.1,tig00000005_polypolish,23888,23889,1
1724,Agrobacterium tumefaciens,4,5,At45.1,tig00000005_polypolish,23940,23941,1
1725,Agrobacterium tumefaciens,4,5,At45.1,tig00000005_polypolish,24017,24019,2
1726,Agrobacterium tumefaciens,4,5,At45.1,tig00000005_polypolish,24145,24146,1
1727,Agrobacterium tumefaciens,4,5,At45.1,tig00000005_polypolish,24153,24154,1
1728,Agrobacterium tumefaciens,4,5,At45.1,tig00000005_polypolish,24239,24240,1
1729,Agrobacterium tumefaciens,4,5,At45.1,tig00000005_polypolish,24385,24386,1
1730,Agrobacterium tumefaciens,4,5,At45.1,tig00000005_polypolish,24390,24391,1
1731,Agrobacterium tumefaciens,4,5,At45.1,tig00000005_polypolish,24623,24624,1
1732,Agrobacterium tumefaciens,4,5,At45.1,tig00000005_polypolish,25000,25001,1
1733,Agrobacterium tumefaciens,4,5,At45.1,tig00000005_polypolish,25150,25151,1
1734,Agrobacterium tumefaciens,4,5,At45.1,tig00000005_polypolish,25239,25240,1
1735,Agrobacterium tumefaciens,4,5,At45.1,tig00000005_polypolish,25252,25253,1
1736,Agrobacterium tumefaciens,4,5,At45.1,tig00000005_polypolish,25625,25626,1
1737,Agrobacterium tumefaciens,4,5,At45.1,tig00000005_polypolish,25636,25637,1
1738,Agrobacterium tumefaciens,4,5,At45.1,tig00000005_polypolish,25707,25708,1
1739,Agrobacterium tumefaciens,4,5,At45.1,tig00000005_polypolish,25713,25714,1
1740,Agrobacterium tumefaciens,4,5,At45.1,tig00000005_polypolish,25795,25796,1
1741,Agrobacterium tumefaciens,4,5,At45.1,tig00000005_polypolish,25930,25932,2
1742,Agrobacterium tumefaciens,4,5,At45.1,tig00000005_polypolish,26061,31114,5053
1743,Comamonas testosteroni,2,1,Ct21.1,tig00000001_polypolish,1,6534,6533
1744,Comamonas testosteroni,2,1,Ct21.1,tig00000001_polypolish,6820,6821,1
1745,Comamonas testosteroni,2,1,Ct21.1,tig00000001_polypolish,7157,7158,1
1746,Comamonas testosteroni,2,1,Ct21.1,tig00000001_polypolish,7450,7451,1
1747,Comamonas testosteroni,2,1,Ct21.1,tig00000001_polypolish,7736,7737,1
1748,Comamonas testosteroni,2,1,Ct21.1,tig00000001_polypolish,7821,7822,1
1749,Comamonas testosteroni,2,1,Ct21.1,tig00000001_polypolish,8000,8001,1
1750,Comamonas testosteroni,2,1,Ct21.1,tig00000001_polypolish,8052,8053,1
1751,Comamonas testosteroni,2,1,Ct21.1,tig00000001_polypolish,10306,10307,1
1752,Comamonas testosteroni,2,1,Ct21.1,tig00000001_polypolish,2606251,2606253,2
1753,Comamonas testosteroni,2,1,Ct21.1,tig00000001_polypolish,2606256,2606292,36
1754,Comamonas testosteroni,2,1,Ct21.1,tig00000001_polypolish,3312045,3312058,13
1755,Comamonas testosteroni,2,1,Ct21.1,tig00000001_polypolish,5464739,5464740,1
1756,Comamonas testosteroni,2,1,Ct21.1,tig00000001_polypolish,5927795,5927796,1
1757,Comamonas testosteroni,2,1,Ct21.1,tig00000001_polypolish,5928220,5928221,1
1758,Comamonas testosteroni,2,1,Ct21.1,tig00000001_polypolish,5928421,5928422,1
1759,Comamonas testosteroni,2,1,Ct21.1,tig00000001_polypolish,5928659,5928660,1
1760,Comamonas testosteroni,2,1,Ct21.1,tig00000001_polypolish,5929161,5931885,2724
1761,Comamonas testosteroni,2,1,Ct21.1,tig00000002_polypolish,0,1806,1806
1762,Comamonas testosteroni,2,1,Ct21.1,tig00000002_polypolish,1894,1895,1
1763,Comamonas testosteroni,2,1,Ct21.1,tig00000002_polypolish,1933,1934,1
1764,Comamonas testosteroni,2,1,Ct21.1,tig00000002_polypolish,1943,1944,1
1765,Comamonas testosteroni,2,1,Ct21.1,tig00000002_polypolish,2003,2004,1
1766,Comamonas testosteroni,2,1,Ct21.1,tig00000002_polypolish,2066,2067,1
1767,Comamonas testosteroni,2,1,Ct21.1,tig00000002_polypolish,2469,2470,1
1768,Comamonas testosteroni,2,1,Ct21.1,tig00000002_polypolish,2490,2491,1
1769,Comamonas testosteroni,2,1,Ct21.1,tig00000002_polypolish,2650,2652,2
1770,Comamonas testosteroni,2,1,Ct21.1,tig00000002_polypolish,2699,2700,1
1771,Comamonas testosteroni,2,1,Ct21.1,tig00000002_polypolish,2807,2808,1
1772,Comamonas testosteroni,2,1,Ct21.1,tig00000002_polypolish,2813,2814,1
1773,Comamonas testosteroni,2,1,Ct21.1,tig00000002_polypolish,2821,2822,1
1774,Comamonas testosteroni,2,1,Ct21.1,tig00000002_polypolish,3398,3400,2
1775,Comamonas testosteroni,2,1,Ct21.1,tig00000002_polypolish,4265,4266,1
1776,Comamonas testosteroni,2,1,Ct21.1,tig00000002_polypolish,4398,4399,1
1777,Comamonas testosteroni,2,1,Ct21.1,tig00000002_polypolish,4812,4813,1
1778,Comamonas testosteroni,2,1,Ct21.1,tig00000002_polypolish,5016,5017,1
1779,Comamonas testosteroni,2,1,Ct21.1,tig00000002_polypolish,5064,5067,3
1780,Comamonas testosteroni,2,1,Ct21.1,tig00000002_polypolish,196165,196166,1
1781,Comamonas testosteroni,2,1,Ct21.1,tig00000002_polypolish,196537,196538,1
1782,Comamonas testosteroni,2,1,Ct21.1,tig00000002_polypolish,196547,196548,1
1783,Comamonas testosteroni,2,1,Ct21.1,tig00000002_polypolish,196551,196552,1
1784,Comamonas testosteroni,2,1,Ct21.1,tig00000002_polypolish,196670,196671,1
1785,Comamonas testosteroni,2,1,Ct21.1,tig00000002_polypolish,196727,196728,1
1786,Comamonas testosteroni,2,1,Ct21.1,tig00000002_polypolish,196917,196918,1
1787,Comamonas testosteroni,2,1,Ct21.1,tig00000002_polypolish,197079,197080,1
1788,Comamonas testosteroni,2,1,Ct21.1,tig00000002_polypolish,197102,197103,1
1789,Comamonas testosteroni,2,1,Ct21.1,tig00000002_polypolish,197108,197109,1
1790,Comamonas testosteroni,2,1,Ct21.1,tig00000002_polypolish,197190,197191,1
1791,Comamonas testosteroni,2,1,Ct21.1,tig00000002_polypolish,197253,197255,2
1792,Comamonas testosteroni,2,1,Ct21.1,tig00000002_polypolish,197379,198853,1474
1793,Comamonas testosteroni,2,2,Ct22.1,tig00000001_polypolish,1,1112,1111
1794,Comamonas testosteroni,2,2,Ct22.1,tig00000001_polypolish,1469,1470,1
1795,Comamonas testosteroni,2,2,Ct22.1,tig00000001_polypolish,2086,2087,1
1796,Comamonas testosteroni,2,2,Ct22.1,tig00000001_polypolish,2323,2324,1
1797,Comamonas testosteroni,2,2,Ct22.1,tig00000001_polypolish,2453,2454,1
1798,Comamonas testosteroni,2,2,Ct22.1,tig00000001_polypolish,4761,4762,1
1799,Comamonas testosteroni,2,2,Ct22.1,tig00000001_polypolish,6820,6821,1
1800,Comamonas testosteroni,2,2,Ct22.1,tig00000001_polypolish,2606252,2606253,1
1801,Comamonas testosteroni,2,2,Ct22.1,tig00000001_polypolish,2606256,2606292,36
1802,Comamonas testosteroni,2,2,Ct22.1,tig00000001_polypolish,3312045,3312058,13
1803,Comamonas testosteroni,2,2,Ct22.1,tig00000001_polypolish,3594764,3594765,1
1804,Comamonas testosteroni,2,2,Ct22.1,tig00000001_polypolish,3767597,3767600,3
1805,Comamonas testosteroni,2,2,Ct22.1,tig00000001_polypolish,5923243,5923244,1
1806,Comamonas testosteroni,2,2,Ct22.1,tig00000001_polypolish,5923504,5923505,1
1807,Comamonas testosteroni,2,2,Ct22.1,tig00000001_polypolish,5924288,5924289,1
1808,Comamonas testosteroni,2,2,Ct22.1,tig00000001_polypolish,5924337,5924339,2
1809,Comamonas testosteroni,2,2,Ct22.1,tig00000001_polypolish,5924662,5924663,1
1810,Comamonas testosteroni,2,2,Ct22.1,tig00000001_polypolish,5924674,5924675,1
1811,Comamonas testosteroni,2,2,Ct22.1,tig00000001_polypolish,5924902,5924904,2
1812,Comamonas testosteroni,2,2,Ct22.1,tig00000001_polypolish,5924909,5924910,1
1813,Comamonas testosteroni,2,2,Ct22.1,tig00000001_polypolish,5925495,5925496,1
1814,Comamonas testosteroni,2,2,Ct22.1,tig00000001_polypolish,5925572,5931885,6313
1815,Comamonas testosteroni,2,2,Ct22.1,tig00000002_polypolish,0,915,915
1816,Comamonas testosteroni,2,2,Ct22.1,tig00000002_polypolish,979,980,1
1817,Comamonas testosteroni,2,2,Ct22.1,tig00000002_polypolish,1035,1036,1
1818,Comamonas testosteroni,2,2,Ct22.1,tig00000002_polypolish,1258,1259,1
1819,Comamonas testosteroni,2,2,Ct22.1,tig00000002_polypolish,1952,1953,1
1820,Comamonas testosteroni,2,2,Ct22.1,tig00000002_polypolish,2086,2087,1
1821,Comamonas testosteroni,2,2,Ct22.1,tig00000002_polypolish,2918,2919,1
1822,Comamonas testosteroni,2,2,Ct22.1,tig00000002_polypolish,3114,3115,1
1823,Comamonas testosteroni,2,2,Ct22.1,tig00000002_polypolish,3276,3277,1
1824,Comamonas testosteroni,2,2,Ct22.1,tig00000002_polypolish,3947,3948,1
1825,Comamonas testosteroni,2,2,Ct22.1,tig00000002_polypolish,4447,4448,1
1826,Comamonas testosteroni,2,2,Ct22.1,tig00000002_polypolish,189367,189368,1
1827,Comamonas testosteroni,2,2,Ct22.1,tig00000002_polypolish,192178,192179,1
1828,Comamonas testosteroni,2,2,Ct22.1,tig00000002_polypolish,193090,193091,1
1829,Comamonas testosteroni,2,2,Ct22.1,tig00000002_polypolish,193137,198853,5716
1830,Comamonas testosteroni,2,3,Ct23.1,tig00000001_polypolish,1,8679,8678
1831,Comamonas testosteroni,2,3,Ct23.1,tig00000001_polypolish,8994,8995,1
1832,Comamonas testosteroni,2,3,Ct23.1,tig00000001_polypolish,2606251,2606253,2
1833,Comamonas testosteroni,2,3,Ct23.1,tig00000001_polypolish,2606256,2606292,36
1834,Comamonas testosteroni,2,3,Ct23.1,tig00000001_polypolish,3312045,3312058,13
1835,Comamonas testosteroni,2,3,Ct23.1,tig00000001_polypolish,5581532,5600459,18927
1836,Comamonas testosteroni,2,3,Ct23.1,tig00000001_polypolish,5919892,5919893,1
1837,Comamonas testosteroni,2,3,Ct23.1,tig00000001_polypolish,5927318,5927319,1
1838,Comamonas testosteroni,2,3,Ct23.1,tig00000001_polypolish,5927486,5927488,2
1839,Comamonas testosteroni,2,3,Ct23.1,tig00000001_polypolish,5927825,5927826,1
1840,Comamonas testosteroni,2,3,Ct23.1,tig00000001_polypolish,5927989,5927990,1
1841,Comamonas testosteroni,2,3,Ct23.1,tig00000001_polypolish,5928026,5931885,3859
1842,Comamonas testosteroni,2,3,Ct23.1,tig00000002_polypolish,0,4136,4136
1843,Comamonas testosteroni,2,3,Ct23.1,tig00000002_polypolish,4287,4288,1
1844,Comamonas testosteroni,2,3,Ct23.1,tig00000002_polypolish,4486,4489,3
1845,Comamonas testosteroni,2,3,Ct23.1,tig00000002_polypolish,4587,4588,1
1846,Comamonas testosteroni,2,3,Ct23.1,tig00000002_polypolish,4659,4660,1
1847,Comamonas testosteroni,2,3,Ct23.1,tig00000002_polypolish,4767,4768,1
1848,Comamonas testosteroni,2,3,Ct23.1,tig00000002_polypolish,5295,5296,1
1849,Comamonas testosteroni,2,3,Ct23.1,tig00000002_polypolish,6570,6571,1
1850,Comamonas testosteroni,2,3,Ct23.1,tig00000002_polypolish,7421,7422,1
1851,Comamonas testosteroni,2,3,Ct23.1,tig00000002_polypolish,7682,7683,1
1852,Comamonas testosteroni,2,3,Ct23.1,tig00000002_polypolish,192178,192179,1
1853,Comamonas testosteroni,2,3,Ct23.1,tig00000002_polypolish,195282,195283,1
1854,Comamonas testosteroni,2,3,Ct23.1,tig00000002_polypolish,195694,195695,1
1855,Comamonas testosteroni,2,3,Ct23.1,tig00000002_polypolish,196350,196351,1
1856,Comamonas testosteroni,2,3,Ct23.1,tig00000002_polypolish,196494,198853,2359
1857,Comamonas testosteroni,2,4,Ct24.1,tig00000001_polypolish,1,2638,2637
1858,Comamonas testosteroni,2,4,Ct24.1,tig00000001_polypolish,2698,2700,2
1859,Comamonas testosteroni,2,4,Ct24.1,tig00000001_polypolish,2902,2903,1
1860,Comamonas testosteroni,2,4,Ct24.1,tig00000001_polypolish,2905,2906,1
1861,Comamonas testosteroni,2,4,Ct24.1,tig00000001_polypolish,5301,5302,1
1862,Comamonas testosteroni,2,4,Ct24.1,tig00000001_polypolish,1680978,1680979,1
1863,Comamonas testosteroni,2,4,Ct24.1,tig00000001_polypolish,2342966,2342967,1
1864,Comamonas testosteroni,2,4,Ct24.1,tig00000001_polypolish,2606252,2606253,1
1865,Comamonas testosteroni,2,4,Ct24.1,tig00000001_polypolish,2606256,2606292,36
1866,Comamonas testosteroni,2,4,Ct24.1,tig00000001_polypolish,3312045,3312058,13
1867,Comamonas testosteroni,2,4,Ct24.1,tig00000001_polypolish,5924224,5924225,1
1868,Comamonas testosteroni,2,4,Ct24.1,tig00000001_polypolish,5924428,5924429,1
1869,Comamonas testosteroni,2,4,Ct24.1,tig00000001_polypolish,5924706,5924707,1
1870,Comamonas testosteroni,2,4,Ct24.1,tig00000001_polypolish,5926473,5926474,1
1871,Comamonas testosteroni,2,4,Ct24.1,tig00000001_polypolish,5926944,5926945,1
1872,Comamonas testosteroni,2,4,Ct24.1,tig00000001_polypolish,5927292,5927293,1
1873,Comamonas testosteroni,2,4,Ct24.1,tig00000001_polypolish,5927359,5927360,1
1874,Comamonas testosteroni,2,4,Ct24.1,tig00000001_polypolish,5927604,5927605,1
1875,Comamonas testosteroni,2,4,Ct24.1,tig00000001_polypolish,5928144,5928145,1
1876,Comamonas testosteroni,2,4,Ct24.1,tig00000001_polypolish,5928899,5928900,1
1877,Comamonas testosteroni,2,4,Ct24.1,tig00000001_polypolish,5928941,5928942,1
1878,Comamonas testosteroni,2,4,Ct24.1,tig00000001_polypolish,5929071,5931885,2814
1879,Comamonas testosteroni,2,4,Ct24.1,tig00000002_polypolish,0,573,573
1880,Comamonas testosteroni,2,4,Ct24.1,tig00000002_polypolish,687,688,1
1881,Comamonas testosteroni,2,4,Ct24.1,tig00000002_polypolish,195465,195466,1
1882,Comamonas testosteroni,2,4,Ct24.1,tig00000002_polypolish,195867,195868,1
1883,Comamonas testosteroni,2,4,Ct24.1,tig00000002_polypolish,195915,195916,1
1884,Comamonas testosteroni,2,4,Ct24.1,tig00000002_polypolish,196077,196078,1
1885,Comamonas testosteroni,2,4,Ct24.1,tig00000002_polypolish,196158,196159,1
1886,Comamonas testosteroni,2,4,Ct24.1,tig00000002_polypolish,196177,196178,1
1887,Comamonas testosteroni,2,4,Ct24.1,tig00000002_polypolish,196249,196250,1
1888,Comamonas testosteroni,2,4,Ct24.1,tig00000002_polypolish,196318,196319,1
1889,Comamonas testosteroni,2,4,Ct24.1,tig00000002_polypolish,196350,196351,1
1890,Comamonas testosteroni,2,4,Ct24.1,tig00000002_polypolish,196470,196471,1
1891,Comamonas testosteroni,2,4,Ct24.1,tig00000002_polypolish,196505,196506,1
1892,Comamonas testosteroni,2,4,Ct24.1,tig00000002_polypolish,196527,196528,1
1893,Comamonas testosteroni,2,4,Ct24.1,tig00000002_polypolish,196547,196548,1
1894,Comamonas testosteroni,2,4,Ct24.1,tig00000002_polypolish,196561,196562,1
1895,Comamonas testosteroni,2,4,Ct24.1,tig00000002_polypolish,196722,196723,1
1896,Comamonas testosteroni,2,4,Ct24.1,tig00000002_polypolish,196814,198853,2039
1897,Comamonas testosteroni,2,5,Ct25.1,tig00000001_polypolish,1,3877,3876
1898,Comamonas testosteroni,2,5,Ct25.1,tig00000001_polypolish,4074,4075,1
1899,Comamonas testosteroni,2,5,Ct25.1,tig00000001_polypolish,4453,4454,1
1900,Comamonas testosteroni,2,5,Ct25.1,tig00000001_polypolish,5006,5007,1
1901,Comamonas testosteroni,2,5,Ct25.1,tig00000001_polypolish,5068,5069,1
1902,Comamonas testosteroni,2,5,Ct25.1,tig00000001_polypolish,5118,5119,1
1903,Comamonas testosteroni,2,5,Ct25.1,tig00000001_polypolish,5283,5284,1
1904,Comamonas testosteroni,2,5,Ct25.1,tig00000001_polypolish,5969,5970,1
1905,Comamonas testosteroni,2,5,Ct25.1,tig00000001_polypolish,6500,6501,1
1906,Comamonas testosteroni,2,5,Ct25.1,tig00000001_polypolish,6745,6746,1
1907,Comamonas testosteroni,2,5,Ct25.1,tig00000001_polypolish,6870,6871,1
1908,Comamonas testosteroni,2,5,Ct25.1,tig00000001_polypolish,7153,7154,1
1909,Comamonas testosteroni,2,5,Ct25.1,tig00000001_polypolish,10515,10516,1
1910,Comamonas testosteroni,2,5,Ct25.1,tig00000001_polypolish,2606251,2606253,2
1911,Comamonas testosteroni,2,5,Ct25.1,tig00000001_polypolish,2606256,2606292,36
1912,Comamonas testosteroni,2,5,Ct25.1,tig00000001_polypolish,3312045,3312058,13
1913,Comamonas testosteroni,2,5,Ct25.1,tig00000001_polypolish,4250739,4250740,1
1914,Comamonas testosteroni,2,5,Ct25.1,tig00000001_polypolish,5038851,5038852,1
1915,Comamonas testosteroni,2,5,Ct25.1,tig00000001_polypolish,5921201,5921202,1
1916,Comamonas testosteroni,2,5,Ct25.1,tig00000001_polypolish,5923603,5923604,1
1917,Comamonas testosteroni,2,5,Ct25.1,tig00000001_polypolish,5924527,5924528,1
1918,Comamonas testosteroni,2,5,Ct25.1,tig00000001_polypolish,5924738,5924739,1
1919,Comamonas testosteroni,2,5,Ct25.1,tig00000001_polypolish,5924869,5924870,1
1920,Comamonas testosteroni,2,5,Ct25.1,tig00000001_polypolish,5925480,5925481,1
1921,Comamonas testosteroni,2,5,Ct25.1,tig00000001_polypolish,5925495,5925496,1
1922,Comamonas testosteroni,2,5,Ct25.1,tig00000001_polypolish,5925560,5931885,6325
1923,Comamonas testosteroni,2,5,Ct25.1,tig00000002_polypolish,0,2532,2532
1924,Comamonas testosteroni,2,5,Ct25.1,tig00000002_polypolish,100732,100733,1
1925,Comamonas testosteroni,2,5,Ct25.1,tig00000002_polypolish,195614,195615,1
1926,Comamonas testosteroni,2,5,Ct25.1,tig00000002_polypolish,195647,195648,1
1927,Comamonas testosteroni,2,5,Ct25.1,tig00000002_polypolish,195697,198853,3156
1928,Comamonas testosteroni,3,1,Ct31.1,tig00000001_polypolish,1,460,459
1929,Comamonas testosteroni,3,1,Ct31.1,tig00000001_polypolish,13155,13156,1
1930,Comamonas testosteroni,3,1,Ct31.1,tig00000001_polypolish,380585,380586,1
1931,Comamonas testosteroni,3,1,Ct31.1,tig00000001_polypolish,745458,745459,1
1932,Comamonas testosteroni,3,1,Ct31.1,tig00000001_polypolish,1013453,1013454,1
1933,Comamonas testosteroni,3,1,Ct31.1,tig00000001_polypolish,2606256,2606292,36
1934,Comamonas testosteroni,3,1,Ct31.1,tig00000001_polypolish,2782443,2782444,1
1935,Comamonas testosteroni,3,1,Ct31.1,tig00000001_polypolish,3303663,3303664,1
1936,Comamonas testosteroni,3,1,Ct31.1,tig00000001_polypolish,3312045,3312058,13
1937,Comamonas testosteroni,3,1,Ct31.1,tig00000001_polypolish,5009351,5009352,1
1938,Comamonas testosteroni,3,1,Ct31.1,tig00000001_polypolish,5681190,5681191,1
1939,Comamonas testosteroni,3,1,Ct31.1,tig00000001_polypolish,5767393,5767394,1
1940,Comamonas testosteroni,3,1,Ct31.1,tig00000001_polypolish,5921441,5921442,1
1941,Comamonas testosteroni,3,1,Ct31.1,tig00000001_polypolish,5926972,5926973,1
1942,Comamonas testosteroni,3,1,Ct31.1,tig00000001_polypolish,5927435,5927436,1
1943,Comamonas testosteroni,3,1,Ct31.1,tig00000001_polypolish,5927516,5927517,1
1944,Comamonas testosteroni,3,1,Ct31.1,tig00000001_polypolish,5927553,5927554,1
1945,Comamonas testosteroni,3,1,Ct31.1,tig00000001_polypolish,5927619,5927620,1
1946,Comamonas testosteroni,3,1,Ct31.1,tig00000001_polypolish,5927667,5927668,1
1947,Comamonas testosteroni,3,1,Ct31.1,tig00000001_polypolish,5927704,5927705,1
1948,Comamonas testosteroni,3,1,Ct31.1,tig00000001_polypolish,5927723,5927724,1
1949,Comamonas testosteroni,3,1,Ct31.1,tig00000001_polypolish,5927741,5927742,1
1950,Comamonas testosteroni,3,1,Ct31.1,tig00000001_polypolish,5927905,5927906,1
1951,Comamonas testosteroni,3,1,Ct31.1,tig00000001_polypolish,5928163,5928165,2
1952,Comamonas testosteroni,3,1,Ct31.1,tig00000001_polypolish,5928713,5928714,1
1953,Comamonas testosteroni,3,1,Ct31.1,tig00000001_polypolish,5928761,5931885,3124
1954,Comamonas testosteroni,3,1,Ct31.1,tig00000002_polypolish,0,3166,3166
1955,Comamonas testosteroni,3,1,Ct31.1,tig00000002_polypolish,5178,5179,1
1956,Comamonas testosteroni,3,1,Ct31.1,tig00000002_polypolish,11244,11245,1
1957,Comamonas testosteroni,3,1,Ct31.1,tig00000002_polypolish,191964,191965,1
1958,Comamonas testosteroni,3,1,Ct31.1,tig00000002_polypolish,193895,193899,4
1959,Comamonas testosteroni,3,1,Ct31.1,tig00000002_polypolish,194970,194971,1
1960,Comamonas testosteroni,3,1,Ct31.1,tig00000002_polypolish,195838,195839,1
1961,Comamonas testosteroni,3,1,Ct31.1,tig00000002_polypolish,197122,198853,1731
1962,Comamonas testosteroni,3,2,Ct32.1,tig00000001_polypolish,1,38,37
1963,Comamonas testosteroni,3,2,Ct32.1,tig00000001_polypolish,695,696,1
1964,Comamonas testosteroni,3,2,Ct32.1,tig00000001_polypolish,943,944,1
1965,Comamonas testosteroni,3,2,Ct32.1,tig00000001_polypolish,1345,1346,1
1966,Comamonas testosteroni,3,2,Ct32.1,tig00000001_polypolish,2343,2344,1
1967,Comamonas testosteroni,3,2,Ct32.1,tig00000001_polypolish,2445636,2445637,1
1968,Comamonas testosteroni,3,2,Ct32.1,tig00000001_polypolish,2606251,2606253,2
1969,Comamonas testosteroni,3,2,Ct32.1,tig00000001_polypolish,2606256,2606292,36
1970,Comamonas testosteroni,3,2,Ct32.1,tig00000001_polypolish,3005287,3005288,1
1971,Comamonas testosteroni,3,2,Ct32.1,tig00000001_polypolish,3312045,3312058,13
1972,Comamonas testosteroni,3,2,Ct32.1,tig00000001_polypolish,5924288,5924289,1
1973,Comamonas testosteroni,3,2,Ct32.1,tig00000001_polypolish,5924527,5924528,1
1974,Comamonas testosteroni,3,2,Ct32.1,tig00000001_polypolish,5924869,5924870,1
1975,Comamonas testosteroni,3,2,Ct32.1,tig00000001_polypolish,5925270,5925271,1
1976,Comamonas testosteroni,3,2,Ct32.1,tig00000001_polypolish,5925370,5925371,1
1977,Comamonas testosteroni,3,2,Ct32.1,tig00000001_polypolish,5925423,5925425,2
1978,Comamonas testosteroni,3,2,Ct32.1,tig00000001_polypolish,5925495,5925496,1
1979,Comamonas testosteroni,3,2,Ct32.1,tig00000001_polypolish,5925522,5925525,3
1980,Comamonas testosteroni,3,2,Ct32.1,tig00000001_polypolish,5925526,5925527,1
1981,Comamonas testosteroni,3,2,Ct32.1,tig00000001_polypolish,5925718,5925719,1
1982,Comamonas testosteroni,3,2,Ct32.1,tig00000001_polypolish,5925846,5925847,1
1983,Comamonas testosteroni,3,2,Ct32.1,tig00000001_polypolish,5926064,5926065,1
1984,Comamonas testosteroni,3,2,Ct32.1,tig00000001_polypolish,5926196,5926197,1
1985,Comamonas testosteroni,3,2,Ct32.1,tig00000001_polypolish,5926924,5926925,1
1986,Comamonas testosteroni,3,2,Ct32.1,tig00000001_polypolish,5926944,5926945,1
1987,Comamonas testosteroni,3,2,Ct32.1,tig00000001_polypolish,5926963,5926964,1
1988,Comamonas testosteroni,3,2,Ct32.1,tig00000001_polypolish,5926981,5931885,4904
1989,Comamonas testosteroni,3,2,Ct32.1,tig00000002_polypolish,0,1220,1220
1990,Comamonas testosteroni,3,2,Ct32.1,tig00000002_polypolish,193893,193894,1
1991,Comamonas testosteroni,3,2,Ct32.1,tig00000002_polypolish,194970,194971,1
1992,Comamonas testosteroni,3,2,Ct32.1,tig00000002_polypolish,195717,195718,1
1993,Comamonas testosteroni,3,2,Ct32.1,tig00000002_polypolish,196410,196411,1
1994,Comamonas testosteroni,3,2,Ct32.1,tig00000002_polypolish,196480,196481,1
1995,Comamonas testosteroni,3,2,Ct32.1,tig00000002_polypolish,197366,198853,1487
1996,Comamonas testosteroni,3,3,Ct33.1,tig00000001_polypolish,1,1545,1544
1997,Comamonas testosteroni,3,3,Ct33.1,tig00000001_polypolish,2430,2431,1
1998,Comamonas testosteroni,3,3,Ct33.1,tig00000001_polypolish,2488,2489,1
1999,Comamonas testosteroni,3,3,Ct33.1,tig00000001_polypolish,1539400,1539401,1
2000,Comamonas testosteroni,3,3,Ct33.1,tig00000001_polypolish,2606251,2606253,2
2001,Comamonas testosteroni,3,3,Ct33.1,tig00000001_polypolish,2606256,2606292,36
2002,Comamonas testosteroni,3,3,Ct33.1,tig00000001_polypolish,3312045,3312058,13
2003,Comamonas testosteroni,3,3,Ct33.1,tig00000001_polypolish,5927180,5927181,1
2004,Comamonas testosteroni,3,3,Ct33.1,tig00000001_polypolish,5927299,5927300,1
2005,Comamonas testosteroni,3,3,Ct33.1,tig00000001_polypolish,5927465,5927466,1
2006,Comamonas testosteroni,3,3,Ct33.1,tig00000001_polypolish,5927636,5927637,1
2007,Comamonas testosteroni,3,3,Ct33.1,tig00000001_polypolish,5927869,5927870,1
2008,Comamonas testosteroni,3,3,Ct33.1,tig00000001_polypolish,5928028,5928030,2
2009,Comamonas testosteroni,3,3,Ct33.1,tig00000001_polypolish,5928208,5928210,2
2010,Comamonas testosteroni,3,3,Ct33.1,tig00000001_polypolish,5928358,5931885,3527
2011,Comamonas testosteroni,3,3,Ct33.1,tig00000002_polypolish,0,2975,2975
2012,Comamonas testosteroni,3,3,Ct33.1,tig00000002_polypolish,3128,3129,1
2013,Comamonas testosteroni,3,3,Ct33.1,tig00000002_polypolish,3163,3164,1
2014,Comamonas testosteroni,3,3,Ct33.1,tig00000002_polypolish,3237,3238,1
2015,Comamonas testosteroni,3,3,Ct33.1,tig00000002_polypolish,3335,3336,1
2016,Comamonas testosteroni,3,3,Ct33.1,tig00000002_polypolish,3724,3726,2
2017,Comamonas testosteroni,3,3,Ct33.1,tig00000002_polypolish,3787,3789,2
2018,Comamonas testosteroni,3,3,Ct33.1,tig00000002_polypolish,3947,3948,1
2019,Comamonas testosteroni,3,3,Ct33.1,tig00000002_polypolish,3982,3983,1
2020,Comamonas testosteroni,3,3,Ct33.1,tig00000002_polypolish,4899,4900,1
2021,Comamonas testosteroni,3,3,Ct33.1,tig00000002_polypolish,112386,112387,1
2022,Comamonas testosteroni,3,3,Ct33.1,tig00000002_polypolish,197657,197658,1
2023,Comamonas testosteroni,3,3,Ct33.1,tig00000002_polypolish,197672,197673,1
2024,Comamonas testosteroni,3,3,Ct33.1,tig00000002_polypolish,197743,197744,1
2025,Comamonas testosteroni,3,3,Ct33.1,tig00000002_polypolish,197781,198853,1072
2026,Comamonas testosteroni,3,4,Ct34.1,tig00000001_polypolish,3223,3224,1
2027,Comamonas testosteroni,3,4,Ct34.1,tig00000001_polypolish,3371,3372,1
2028,Comamonas testosteroni,3,4,Ct34.1,tig00000001_polypolish,418411,418412,1
2029,Comamonas testosteroni,3,4,Ct34.1,tig00000001_polypolish,2606251,2606253,2
2030,Comamonas testosteroni,3,4,Ct34.1,tig00000001_polypolish,2606256,2606292,36
2031,Comamonas testosteroni,3,4,Ct34.1,tig00000001_polypolish,3067009,3067010,1
2032,Comamonas testosteroni,3,4,Ct34.1,tig00000001_polypolish,3312045,3312058,13
2033,Comamonas testosteroni,3,4,Ct34.1,tig00000001_polypolish,5719842,5719843,1
2034,Comamonas testosteroni,3,4,Ct34.1,tig00000001_polypolish,5720489,5720490,1
2035,Comamonas testosteroni,3,4,Ct34.1,tig00000001_polypolish,5721029,5721030,1
2036,Comamonas testosteroni,3,4,Ct34.1,tig00000001_polypolish,5723056,5723057,1
2037,Comamonas testosteroni,3,4,Ct34.1,tig00000001_polypolish,5927685,5927686,1
2038,Comamonas testosteroni,3,4,Ct34.1,tig00000001_polypolish,5928016,5928017,1
2039,Comamonas testosteroni,3,4,Ct34.1,tig00000001_polypolish,5928379,5928380,1
2040,Comamonas testosteroni,3,4,Ct34.1,tig00000001_polypolish,5929060,5931885,2825
2041,Comamonas testosteroni,3,4,Ct34.1,tig00000002_polypolish,0,1185,1185
2042,Comamonas testosteroni,3,4,Ct34.1,tig00000002_polypolish,1231,1232,1
2043,Comamonas testosteroni,3,4,Ct34.1,tig00000002_polypolish,1576,1578,2
2044,Comamonas testosteroni,3,4,Ct34.1,tig00000002_polypolish,1693,1694,1
2045,Comamonas testosteroni,3,4,Ct34.1,tig00000002_polypolish,2080,2081,1
2046,Comamonas testosteroni,3,4,Ct34.1,tig00000002_polypolish,190789,190790,1
2047,Comamonas testosteroni,3,4,Ct34.1,tig00000002_polypolish,191794,191796,2
2048,Comamonas testosteroni,3,4,Ct34.1,tig00000002_polypolish,191971,191973,2
2049,Comamonas testosteroni,3,4,Ct34.1,tig00000002_polypolish,192151,192152,1
2050,Comamonas testosteroni,3,4,Ct34.1,tig00000002_polypolish,192194,192196,2
2051,Comamonas testosteroni,3,4,Ct34.1,tig00000002_polypolish,192226,198853,6627
2052,Comamonas testosteroni,3,5,Ct35.1,tig00000001_polypolish,1,3632,3631
2053,Comamonas testosteroni,3,5,Ct35.1,tig00000001_polypolish,3698,3699,1
2054,Comamonas testosteroni,3,5,Ct35.1,tig00000001_polypolish,2606251,2606253,2
2055,Comamonas testosteroni,3,5,Ct35.1,tig00000001_polypolish,2606256,2606292,36
2056,Comamonas testosteroni,3,5,Ct35.1,tig00000001_polypolish,2982810,2982811,1
2057,Comamonas testosteroni,3,5,Ct35.1,tig00000001_polypolish,3312045,3312058,13
2058,Comamonas testosteroni,3,5,Ct35.1,tig00000001_polypolish,4434492,4434498,6
2059,Comamonas testosteroni,3,5,Ct35.1,tig00000001_polypolish,5205591,5205592,1
2060,Comamonas testosteroni,3,5,Ct35.1,tig00000001_polypolish,5927782,5927783,1
2061,Comamonas testosteroni,3,5,Ct35.1,tig00000001_polypolish,5928954,5928955,1
2062,Comamonas testosteroni,3,5,Ct35.1,tig00000001_polypolish,5929021,5929022,1
2063,Comamonas testosteroni,3,5,Ct35.1,tig00000001_polypolish,5929131,5929132,1
2064,Comamonas testosteroni,3,5,Ct35.1,tig00000001_polypolish,5929166,5931885,2719
2065,Comamonas testosteroni,3,5,Ct35.1,tig00000002_polypolish,0,2163,2163
2066,Comamonas testosteroni,3,5,Ct35.1,tig00000002_polypolish,197054,197055,1
2067,Comamonas testosteroni,3,5,Ct35.1,tig00000002_polypolish,197185,197186,1
2068,Comamonas testosteroni,3,5,Ct35.1,tig00000002_polypolish,197242,197243,1
2069,Comamonas testosteroni,3,5,Ct35.1,tig00000002_polypolish,197353,197354,1
2070,Comamonas testosteroni,3,5,Ct35.1,tig00000002_polypolish,197389,197390,1
2071,Comamonas testosteroni,3,5,Ct35.1,tig00000002_polypolish,197475,197476,1
2072,Comamonas testosteroni,3,5,Ct35.1,tig00000002_polypolish,197540,197542,2
2073,Comamonas testosteroni,3,5,Ct35.1,tig00000002_polypolish,197767,198853,1086
2074,Comamonas testosteroni,4,1,Ct41.1,tig00000001_polypolish,1,5302,5301
2075,Comamonas testosteroni,4,1,Ct41.1,tig00000001_polypolish,5604,5605,1
2076,Comamonas testosteroni,4,1,Ct41.1,tig00000001_polypolish,6048,6049,1
2077,Comamonas testosteroni,4,1,Ct41.1,tig00000001_polypolish,6396,6398,2
2078,Comamonas testosteroni,4,1,Ct41.1,tig00000001_polypolish,7482,7483,1
2079,Comamonas testosteroni,4,1,Ct41.1,tig00000001_polypolish,8194,8195,1
2080,Comamonas testosteroni,4,1,Ct41.1,tig00000001_polypolish,9323,9324,1
2081,Comamonas testosteroni,4,1,Ct41.1,tig00000001_polypolish,2606251,2606253,2
2082,Comamonas testosteroni,4,1,Ct41.1,tig00000001_polypolish,2606256,2606292,36
2083,Comamonas testosteroni,4,1,Ct41.1,tig00000001_polypolish,2963090,2963091,1
2084,Comamonas testosteroni,4,1,Ct41.1,tig00000001_polypolish,2993499,2993500,1
2085,Comamonas testosteroni,4,1,Ct41.1,tig00000001_polypolish,3312045,3312058,13
2086,Comamonas testosteroni,4,1,Ct41.1,tig00000001_polypolish,5929450,5929451,1
2087,Comamonas testosteroni,4,1,Ct41.1,tig00000001_polypolish,5929505,5929506,1
2088,Comamonas testosteroni,4,1,Ct41.1,tig00000001_polypolish,5929771,5931885,2114
2089,Comamonas testosteroni,4,1,Ct41.1,tig00000002_polypolish,0,778,778
2090,Comamonas testosteroni,4,1,Ct41.1,tig00000002_polypolish,802,803,1
2091,Comamonas testosteroni,4,1,Ct41.1,tig00000002_polypolish,192609,192610,1
2092,Comamonas testosteroni,4,1,Ct41.1,tig00000002_polypolish,192792,192793,1
2093,Comamonas testosteroni,4,1,Ct41.1,tig00000002_polypolish,193928,193929,1
2094,Comamonas testosteroni,4,1,Ct41.1,tig00000002_polypolish,194970,194972,2
2095,Comamonas testosteroni,4,1,Ct41.1,tig00000002_polypolish,195923,195924,1
2096,Comamonas testosteroni,4,1,Ct41.1,tig00000002_polypolish,196124,198853,2729
2097,Comamonas testosteroni,4,2,Ct42.1,tig00000001_polypolish,1,675,674
2098,Comamonas testosteroni,4,2,Ct42.1,tig00000001_polypolish,845,846,1
2099,Comamonas testosteroni,4,2,Ct42.1,tig00000001_polypolish,1037,1040,3
2100,Comamonas testosteroni,4,2,Ct42.1,tig00000001_polypolish,1571,1572,1
2101,Comamonas testosteroni,4,2,Ct42.1,tig00000001_polypolish,508660,508661,1
2102,Comamonas testosteroni,4,2,Ct42.1,tig00000001_polypolish,511471,511472,1
2103,Comamonas testosteroni,4,2,Ct42.1,tig00000001_polypolish,663769,663770,1
2104,Comamonas testosteroni,4,2,Ct42.1,tig00000001_polypolish,955938,955939,1
2105,Comamonas testosteroni,4,2,Ct42.1,tig00000001_polypolish,973787,973788,1
2106,Comamonas testosteroni,4,2,Ct42.1,tig00000001_polypolish,1824591,1824592,1
2107,Comamonas testosteroni,4,2,Ct42.1,tig00000001_polypolish,2606257,2606292,35
2108,Comamonas testosteroni,4,2,Ct42.1,tig00000001_polypolish,2963090,2963091,1
2109,Comamonas testosteroni,4,2,Ct42.1,tig00000001_polypolish,3205265,3205266,1
2110,Comamonas testosteroni,4,2,Ct42.1,tig00000001_polypolish,3312045,3312058,13
2111,Comamonas testosteroni,4,2,Ct42.1,tig00000001_polypolish,4346793,4346794,1
2112,Comamonas testosteroni,4,2,Ct42.1,tig00000001_polypolish,4698047,4698048,1
2113,Comamonas testosteroni,4,2,Ct42.1,tig00000001_polypolish,5251464,5251465,1
2114,Comamonas testosteroni,4,2,Ct42.1,tig00000001_polypolish,5312857,5312858,1
2115,Comamonas testosteroni,4,2,Ct42.1,tig00000001_polypolish,5734692,5734693,1
2116,Comamonas testosteroni,4,2,Ct42.1,tig00000001_polypolish,5923982,5923983,1
2117,Comamonas testosteroni,4,2,Ct42.1,tig00000001_polypolish,5925168,5925169,1
2118,Comamonas testosteroni,4,2,Ct42.1,tig00000001_polypolish,5925334,5925335,1
2119,Comamonas testosteroni,4,2,Ct42.1,tig00000001_polypolish,5925458,5925459,1
2120,Comamonas testosteroni,4,2,Ct42.1,tig00000001_polypolish,5925495,5925496,1
2121,Comamonas testosteroni,4,2,Ct42.1,tig00000001_polypolish,5926074,5926075,1
2122,Comamonas testosteroni,4,2,Ct42.1,tig00000001_polypolish,5926544,5926545,1
2123,Comamonas testosteroni,4,2,Ct42.1,tig00000001_polypolish,5926628,5926629,1
2124,Comamonas testosteroni,4,2,Ct42.1,tig00000001_polypolish,5928719,5928720,1
2125,Comamonas testosteroni,4,2,Ct42.1,tig00000001_polypolish,5928813,5928814,1
2126,Comamonas testosteroni,4,2,Ct42.1,tig00000001_polypolish,5928869,5928870,1
2127,Comamonas testosteroni,4,2,Ct42.1,tig00000001_polypolish,5928884,5928885,1
2128,Comamonas testosteroni,4,2,Ct42.1,tig00000001_polypolish,5928889,5928890,1
2129,Comamonas testosteroni,4,2,Ct42.1,tig00000001_polypolish,5928918,5928919,1
2130,Comamonas testosteroni,4,2,Ct42.1,tig00000001_polypolish,5928972,5928973,1
2131,Comamonas testosteroni,4,2,Ct42.1,tig00000001_polypolish,5929000,5929001,1
2132,Comamonas testosteroni,4,2,Ct42.1,tig00000001_polypolish,5929131,5929132,1
2133,Comamonas testosteroni,4,2,Ct42.1,tig00000001_polypolish,5929203,5931885,2682
2134,Comamonas testosteroni,4,2,Ct42.1,tig00000002_polypolish,0,1596,1596
2135,Comamonas testosteroni,4,2,Ct42.1,tig00000002_polypolish,2163,2164,1
2136,Comamonas testosteroni,4,2,Ct42.1,tig00000002_polypolish,2980,2981,1
2137,Comamonas testosteroni,4,2,Ct42.1,tig00000002_polypolish,196670,196671,1
2138,Comamonas testosteroni,4,2,Ct42.1,tig00000002_polypolish,197357,197358,1
2139,Comamonas testosteroni,4,2,Ct42.1,tig00000002_polypolish,197657,197658,1
2140,Comamonas testosteroni,4,2,Ct42.1,tig00000002_polypolish,198177,198853,676
2141,Comamonas testosteroni,4,2,Ct42.2,tig00000001_polypolish,1,479,478
2142,Comamonas testosteroni,4,2,Ct42.2,tig00000001_polypolish,821,822,1
2143,Comamonas testosteroni,4,2,Ct42.2,tig00000001_polypolish,1027,1028,1
2144,Comamonas testosteroni,4,2,Ct42.2,tig00000001_polypolish,1201,1202,1
2145,Comamonas testosteroni,4,2,Ct42.2,tig00000001_polypolish,2020,2021,1
2146,Comamonas testosteroni,4,2,Ct42.2,tig00000001_polypolish,2606256,2606292,36
2147,Comamonas testosteroni,4,2,Ct42.2,tig00000001_polypolish,3312045,3312058,13
2148,Comamonas testosteroni,4,2,Ct42.2,tig00000001_polypolish,4864250,4864251,1
2149,Comamonas testosteroni,4,2,Ct42.2,tig00000001_polypolish,5638639,5783915,145276
2150,Comamonas testosteroni,4,2,Ct42.2,tig00000001_polypolish,5783968,5783970,2
2151,Comamonas testosteroni,4,2,Ct42.2,tig00000001_polypolish,5927226,5927227,1
2152,Comamonas testosteroni,4,2,Ct42.2,tig00000001_polypolish,5927692,5927693,1
2153,Comamonas testosteroni,4,2,Ct42.2,tig00000001_polypolish,5929099,5929100,1
2154,Comamonas testosteroni,4,2,Ct42.2,tig00000001_polypolish,5929324,5929325,1
2155,Comamonas testosteroni,4,2,Ct42.2,tig00000001_polypolish,5929701,5931885,2184
2156,Comamonas testosteroni,4,2,Ct42.2,tig00000002_polypolish,0,5242,5242
2157,Comamonas testosteroni,4,2,Ct42.2,tig00000002_polypolish,5421,5422,1
2158,Comamonas testosteroni,4,2,Ct42.2,tig00000002_polypolish,5515,5516,1
2159,Comamonas testosteroni,4,2,Ct42.2,tig00000002_polypolish,5619,5620,1
2160,Comamonas testosteroni,4,2,Ct42.2,tig00000002_polypolish,5837,5838,1
2161,Comamonas testosteroni,4,2,Ct42.2,tig00000002_polypolish,5858,5859,1
2162,Comamonas testosteroni,4,2,Ct42.2,tig00000002_polypolish,5898,5900,2
2163,Comamonas testosteroni,4,2,Ct42.2,tig00000002_polypolish,6117,6118,1
2164,Comamonas testosteroni,4,2,Ct42.2,tig00000002_polypolish,6247,6248,1
2165,Comamonas testosteroni,4,2,Ct42.2,tig00000002_polypolish,6356,6357,1
2166,Comamonas testosteroni,4,2,Ct42.2,tig00000002_polypolish,6769,6770,1
2167,Comamonas testosteroni,4,2,Ct42.2,tig00000002_polypolish,6900,6901,1
2168,Comamonas testosteroni,4,2,Ct42.2,tig00000002_polypolish,195146,195149,3
2169,Comamonas testosteroni,4,2,Ct42.2,tig00000002_polypolish,195150,195152,2
2170,Comamonas testosteroni,4,2,Ct42.2,tig00000002_polypolish,195295,195296,1
2171,Comamonas testosteroni,4,2,Ct42.2,tig00000002_polypolish,195465,195466,1
2172,Comamonas testosteroni,4,2,Ct42.2,tig00000002_polypolish,195923,195924,1
2173,Comamonas testosteroni,4,2,Ct42.2,tig00000002_polypolish,196005,196006,1
2174,Comamonas testosteroni,4,2,Ct42.2,tig00000002_polypolish,196349,198853,2504
2175,Comamonas testosteroni,4,3,Ct43.1,tig00000001_polypolish,1,1697,1696
2176,Comamonas testosteroni,4,3,Ct43.1,tig00000001_polypolish,428767,428768,1
2177,Comamonas testosteroni,4,3,Ct43.1,tig00000001_polypolish,2606251,2606253,2
2178,Comamonas testosteroni,4,3,Ct43.1,tig00000001_polypolish,2606256,2606292,36
2179,Comamonas testosteroni,4,3,Ct43.1,tig00000001_polypolish,3312045,3312058,13
2180,Comamonas testosteroni,4,3,Ct43.1,tig00000001_polypolish,3655239,3655240,1
2181,Comamonas testosteroni,4,3,Ct43.1,tig00000001_polypolish,3665764,3665765,1
2182,Comamonas testosteroni,4,3,Ct43.1,tig00000001_polypolish,4345469,4345470,1
2183,Comamonas testosteroni,4,3,Ct43.1,tig00000001_polypolish,5644689,5644690,1
2184,Comamonas testosteroni,4,3,Ct43.1,tig00000001_polypolish,5923256,5923257,1
2185,Comamonas testosteroni,4,3,Ct43.1,tig00000001_polypolish,5923566,5923567,1
2186,Comamonas testosteroni,4,3,Ct43.1,tig00000001_polypolish,5924268,5924269,1
2187,Comamonas testosteroni,4,3,Ct43.1,tig00000001_polypolish,5924532,5924533,1
2188,Comamonas testosteroni,4,3,Ct43.1,tig00000001_polypolish,5924662,5924663,1
2189,Comamonas testosteroni,4,3,Ct43.1,tig00000001_polypolish,5925010,5925011,1
2190,Comamonas testosteroni,4,3,Ct43.1,tig00000001_polypolish,5925194,5931885,6691
2191,Comamonas testosteroni,4,3,Ct43.1,tig00000002_polypolish,0,988,988
2192,Comamonas testosteroni,4,3,Ct43.1,tig00000002_polypolish,2003,2004,1
2193,Comamonas testosteroni,4,3,Ct43.1,tig00000002_polypolish,23208,24947,1739
2194,Comamonas testosteroni,4,3,Ct43.1,tig00000002_polypolish,195503,195504,1
2195,Comamonas testosteroni,4,3,Ct43.1,tig00000002_polypolish,195723,195724,1
2196,Comamonas testosteroni,4,3,Ct43.1,tig00000002_polypolish,195856,198853,2997
2197,Comamonas testosteroni,4,4,Ct44.1,tig00000001_polypolish,1,468,467
2198,Comamonas testosteroni,4,4,Ct44.1,tig00000001_polypolish,2172452,2172453,1
2199,Comamonas testosteroni,4,4,Ct44.1,tig00000001_polypolish,2606251,2606253,2
2200,Comamonas testosteroni,4,4,Ct44.1,tig00000001_polypolish,2606256,2606292,36
2201,Comamonas testosteroni,4,4,Ct44.1,tig00000001_polypolish,3312045,3312058,13
2202,Comamonas testosteroni,4,4,Ct44.1,tig00000001_polypolish,4746179,4746180,1
2203,Comamonas testosteroni,4,4,Ct44.1,tig00000001_polypolish,5847731,5847732,1
2204,Comamonas testosteroni,4,4,Ct44.1,tig00000001_polypolish,5925211,5925212,1
2205,Comamonas testosteroni,4,4,Ct44.1,tig00000001_polypolish,5926151,5926155,4
2206,Comamonas testosteroni,4,4,Ct44.1,tig00000001_polypolish,5926411,5926412,1
2207,Comamonas testosteroni,4,4,Ct44.1,tig00000001_polypolish,5926598,5926599,1
2208,Comamonas testosteroni,4,4,Ct44.1,tig00000001_polypolish,5926787,5926788,1
2209,Comamonas testosteroni,4,4,Ct44.1,tig00000001_polypolish,5926809,5926810,1
2210,Comamonas testosteroni,4,4,Ct44.1,tig00000001_polypolish,5926917,5926918,1
2211,Comamonas testosteroni,4,4,Ct44.1,tig00000001_polypolish,5927324,5927325,1
2212,Comamonas testosteroni,4,4,Ct44.1,tig00000001_polypolish,5927333,5927334,1
2213,Comamonas testosteroni,4,4,Ct44.1,tig00000001_polypolish,5927347,5927348,1
2214,Comamonas testosteroni,4,4,Ct44.1,tig00000001_polypolish,5927825,5927826,1
2215,Comamonas testosteroni,4,4,Ct44.1,tig00000001_polypolish,5927834,5931885,4051
2216,Comamonas testosteroni,4,4,Ct44.1,tig00000002_polypolish,0,6680,6680
2217,Comamonas testosteroni,4,4,Ct44.1,tig00000002_polypolish,6764,6765,1
2218,Comamonas testosteroni,4,4,Ct44.1,tig00000002_polypolish,8383,8384,1
2219,Comamonas testosteroni,4,4,Ct44.1,tig00000002_polypolish,195428,195429,1
2220,Comamonas testosteroni,4,4,Ct44.1,tig00000002_polypolish,195722,195723,1
2221,Comamonas testosteroni,4,4,Ct44.1,tig00000002_polypolish,196140,196143,3
2222,Comamonas testosteroni,4,4,Ct44.1,tig00000002_polypolish,196380,196381,1
2223,Comamonas testosteroni,4,4,Ct44.1,tig00000002_polypolish,196454,196455,1
2224,Comamonas testosteroni,4,4,Ct44.1,tig00000002_polypolish,196893,198853,1960
2225,Comamonas testosteroni,4,5,Ct45.1,tig00000001_polypolish,1,2127,2126
2226,Comamonas testosteroni,4,5,Ct45.1,tig00000001_polypolish,7153,7154,1
2227,Comamonas testosteroni,4,5,Ct45.1,tig00000001_polypolish,2606251,2606253,2
2228,Comamonas testosteroni,4,5,Ct45.1,tig00000001_polypolish,2606256,2606292,36
2229,Comamonas testosteroni,4,5,Ct45.1,tig00000001_polypolish,3312045,3312058,13
2230,Comamonas testosteroni,4,5,Ct45.1,tig00000001_polypolish,4699601,4699602,1
2231,Comamonas testosteroni,4,5,Ct45.1,tig00000001_polypolish,5638639,5783915,145276
2232,Comamonas testosteroni,4,5,Ct45.1,tig00000001_polypolish,5783968,5783970,2
2233,Comamonas testosteroni,4,5,Ct45.1,tig00000001_polypolish,5928193,5928194,1
2234,Comamonas testosteroni,4,5,Ct45.1,tig00000001_polypolish,5928461,5931885,3424
2235,Comamonas testosteroni,4,5,Ct45.1,tig00000002_polypolish,0,6381,6381
2236,Comamonas testosteroni,4,5,Ct45.1,tig00000002_polypolish,6613,6615,2
2237,Comamonas testosteroni,4,5,Ct45.1,tig00000002_polypolish,7132,7133,1
2238,Comamonas testosteroni,4,5,Ct45.1,tig00000002_polypolish,196891,196893,2
2239,Comamonas testosteroni,4,5,Ct45.1,tig00000002_polypolish,197055,197056,1
2240,Comamonas testosteroni,4,5,Ct45.1,tig00000002_polypolish,197357,197358,1
2241,Comamonas testosteroni,4,5,Ct45.1,tig00000002_polypolish,197509,198853,1344
2242,Microbacterium saperdae,3,1,Ms31.1,tig00000001_polypolish,1,1827,1826
2243,Microbacterium saperdae,3,1,Ms31.1,tig00000001_polypolish,2124,2125,1
2244,Microbacterium saperdae,3,1,Ms31.1,tig00000001_polypolish,2184,2185,1
2245,Microbacterium saperdae,3,1,Ms31.1,tig00000001_polypolish,2202,2203,1
2246,Microbacterium saperdae,3,1,Ms31.1,tig00000001_polypolish,2435,2436,1
2247,Microbacterium saperdae,3,1,Ms31.1,tig00000001_polypolish,2482,2483,1
2248,Microbacterium saperdae,3,1,Ms31.1,tig00000001_polypolish,2742,2743,1
2249,Microbacterium saperdae,3,1,Ms31.1,tig00000001_polypolish,2890,2891,1
2250,Microbacterium saperdae,3,1,Ms31.1,tig00000001_polypolish,2899,2900,1
2251,Microbacterium saperdae,3,1,Ms31.1,tig00000001_polypolish,2904,2905,1
2252,Microbacterium saperdae,3,1,Ms31.1,tig00000001_polypolish,2963,2964,1
2253,Microbacterium saperdae,3,1,Ms31.1,tig00000001_polypolish,3048,3049,1
2254,Microbacterium saperdae,3,1,Ms31.1,tig00000001_polypolish,3266,3268,2
2255,Microbacterium saperdae,3,1,Ms31.1,tig00000001_polypolish,3890,3891,1
2256,Microbacterium saperdae,3,1,Ms31.1,tig00000001_polypolish,1953154,1953156,2
2257,Microbacterium saperdae,3,1,Ms31.1,tig00000001_polypolish,2193771,2193783,12
2258,Microbacterium saperdae,3,1,Ms31.1,tig00000001_polypolish,3683425,3683432,7
2259,Microbacterium saperdae,3,1,Ms31.1,tig00000001_polypolish,3754287,3754288,1
2260,Microbacterium saperdae,3,1,Ms31.1,tig00000001_polypolish,3756367,3756368,1
2261,Microbacterium saperdae,3,1,Ms31.1,tig00000001_polypolish,3756578,3756579,1
2262,Microbacterium saperdae,3,1,Ms31.1,tig00000001_polypolish,3757060,3757061,1
2263,Microbacterium saperdae,3,1,Ms31.1,tig00000001_polypolish,3757505,3757506,1
2264,Microbacterium saperdae,3,1,Ms31.1,tig00000001_polypolish,3757603,3757604,1
2265,Microbacterium saperdae,3,1,Ms31.1,tig00000001_polypolish,3757619,3757620,1
2266,Microbacterium saperdae,3,1,Ms31.1,tig00000001_polypolish,3758034,3758035,1
2267,Microbacterium saperdae,3,1,Ms31.1,tig00000001_polypolish,3758824,3758825,1
2268,Microbacterium saperdae,3,1,Ms31.1,tig00000001_polypolish,3758852,3761082,2230
2269,Microbacterium saperdae,3,2,Ms32.1,tig00000001_polypolish,1,450,449
2270,Microbacterium saperdae,3,2,Ms32.1,tig00000001_polypolish,754,755,1
2271,Microbacterium saperdae,3,2,Ms32.1,tig00000001_polypolish,803,804,1
2272,Microbacterium saperdae,3,2,Ms32.1,tig00000001_polypolish,951,952,1
2273,Microbacterium saperdae,3,2,Ms32.1,tig00000001_polypolish,819461,819484,23
2274,Microbacterium saperdae,3,2,Ms32.1,tig00000001_polypolish,3756059,3756060,1
2275,Microbacterium saperdae,3,2,Ms32.1,tig00000001_polypolish,3756380,3756381,1
2276,Microbacterium saperdae,3,2,Ms32.1,tig00000001_polypolish,3756708,3756709,1
2277,Microbacterium saperdae,3,2,Ms32.1,tig00000001_polypolish,3757506,3757507,1
2278,Microbacterium saperdae,3,2,Ms32.1,tig00000001_polypolish,3757536,3757537,1
2279,Microbacterium saperdae,3,2,Ms32.1,tig00000001_polypolish,3757825,3757826,1
2280,Microbacterium saperdae,3,2,Ms32.1,tig00000001_polypolish,3758355,3758356,1
2281,Microbacterium saperdae,3,2,Ms32.1,tig00000001_polypolish,3758619,3758620,1
2282,Microbacterium saperdae,3,2,Ms32.1,tig00000001_polypolish,3758931,3758932,1
2283,Microbacterium saperdae,3,2,Ms32.1,tig00000001_polypolish,3759014,3759015,1
2284,Microbacterium saperdae,3,2,Ms32.1,tig00000001_polypolish,3759020,3759021,1
2285,Microbacterium saperdae,3,2,Ms32.1,tig00000001_polypolish,3759084,3759085,1
2286,Microbacterium saperdae,3,2,Ms32.1,tig00000001_polypolish,3759095,3759096,1
2287,Microbacterium saperdae,3,2,Ms32.1,tig00000001_polypolish,3759137,3759138,1
2288,Microbacterium saperdae,3,2,Ms32.1,tig00000001_polypolish,3759194,3759195,1
2289,Microbacterium saperdae,3,2,Ms32.1,tig00000001_polypolish,3759380,3759381,1
2290,Microbacterium saperdae,3,2,Ms32.1,tig00000001_polypolish,3759415,3759416,1
2291,Microbacterium saperdae,3,2,Ms32.1,tig00000001_polypolish,3759684,3761082,1398
2292,Microbacterium saperdae,3,3,Ms33.1,tig00000001_polypolish,1,1415,1414
2293,Microbacterium saperdae,3,3,Ms33.1,tig00000001_polypolish,1574,1575,1
2294,Microbacterium saperdae,3,3,Ms33.1,tig00000001_polypolish,1815,1816,1
2295,Microbacterium saperdae,3,3,Ms33.1,tig00000001_polypolish,2202,2203,1
2296,Microbacterium saperdae,3,3,Ms33.1,tig00000001_polypolish,2742,2743,1
2297,Microbacterium saperdae,3,3,Ms33.1,tig00000001_polypolish,497025,497034,9
2298,Microbacterium saperdae,3,3,Ms33.1,tig00000001_polypolish,3760492,3760493,1
2299,Microbacterium saperdae,3,3,Ms33.1,tig00000001_polypolish,3760563,3761082,519
2300,Microbacterium saperdae,3,4,Ms34.1,tig00000001_polypolish,1,3561,3560
2301,Microbacterium saperdae,3,4,Ms34.1,tig00000001_polypolish,3758912,3758913,1
2302,Microbacterium saperdae,3,4,Ms34.1,tig00000001_polypolish,3759006,3759007,1
2303,Microbacterium saperdae,3,4,Ms34.1,tig00000001_polypolish,3759058,3759060,2
2304,Microbacterium saperdae,3,4,Ms34.1,tig00000001_polypolish,3759126,3759128,2
2305,Microbacterium saperdae,3,4,Ms34.1,tig00000001_polypolish,3759168,3759169,1
2306,Microbacterium saperdae,3,4,Ms34.1,tig00000001_polypolish,3759175,3759176,1
2307,Microbacterium saperdae,3,4,Ms34.1,tig00000001_polypolish,3759202,3759203,1
2308,Microbacterium saperdae,3,4,Ms34.1,tig00000001_polypolish,3759220,3761082,1862
2309,Microbacterium saperdae,3,5,Ms35.1,tig00000001_polypolish,1,350,349
2310,Microbacterium saperdae,3,5,Ms35.1,tig00000001_polypolish,473,474,1
2311,Microbacterium saperdae,3,5,Ms35.1,tig00000001_polypolish,550,551,1
2312,Microbacterium saperdae,3,5,Ms35.1,tig00000001_polypolish,670,671,1
2313,Microbacterium saperdae,3,5,Ms35.1,tig00000001_polypolish,765,766,1
2314,Microbacterium saperdae,3,5,Ms35.1,tig00000001_polypolish,793,795,2
2315,Microbacterium saperdae,3,5,Ms35.1,tig00000001_polypolish,1051,1056,5
2316,Microbacterium saperdae,3,5,Ms35.1,tig00000001_polypolish,1254,1255,1
2317,Microbacterium saperdae,3,5,Ms35.1,tig00000001_polypolish,1305,1306,1
2318,Microbacterium saperdae,3,5,Ms35.1,tig00000001_polypolish,1779,1780,1
2319,Microbacterium saperdae,3,5,Ms35.1,tig00000001_polypolish,838694,838727,33
2320,Microbacterium saperdae,3,5,Ms35.1,tig00000001_polypolish,3756941,3756942,1
2321,Microbacterium saperdae,3,5,Ms35.1,tig00000001_polypolish,3757908,3757909,1
2322,Microbacterium saperdae,3,5,Ms35.1,tig00000001_polypolish,3760287,3760288,1
2323,Microbacterium saperdae,3,5,Ms35.1,tig00000001_polypolish,3760620,3760621,1
2324,Microbacterium saperdae,3,5,Ms35.1,tig00000001_polypolish,3760886,3761082,196
2325,Microbacterium saperdae,4,2,Ms42.1,tig00000001_polypolish,1,311,310
2326,Microbacterium saperdae,4,2,Ms42.1,tig00000001_polypolish,438,439,1
2327,Microbacterium saperdae,4,2,Ms42.1,tig00000001_polypolish,606,607,1
2328,Microbacterium saperdae,4,2,Ms42.1,tig00000001_polypolish,320437,320438,1
2329,Microbacterium saperdae,4,2,Ms42.1,tig00000001_polypolish,1837676,1837801,125
2330,Microbacterium saperdae,4,2,Ms42.1,tig00000001_polypolish,1953154,1953156,2
2331,Microbacterium saperdae,4,2,Ms42.1,tig00000001_polypolish,2197905,2197908,3
2332,Microbacterium saperdae,4,2,Ms42.1,tig00000001_polypolish,3683635,3683637,2
2333,Microbacterium saperdae,4,2,Ms42.1,tig00000001_polypolish,3758421,3758422,1
2334,Microbacterium saperdae,4,2,Ms42.1,tig00000001_polypolish,3759254,3759255,1
2335,Microbacterium saperdae,4,2,Ms42.1,tig00000001_polypolish,3760365,3761082,717
2336,Microbacterium saperdae,4,3,Ms43.1,tig00000001_polypolish,1,3324,3323
2337,Microbacterium saperdae,4,3,Ms43.1,tig00000001_polypolish,537516,537518,2
2338,Microbacterium saperdae,4,3,Ms43.1,tig00000001_polypolish,3758655,3758656,1
2339,Microbacterium saperdae,4,3,Ms43.1,tig00000001_polypolish,3759020,3759021,1
2340,Microbacterium saperdae,4,3,Ms43.1,tig00000001_polypolish,3759137,3759138,1
2341,Microbacterium saperdae,4,3,Ms43.1,tig00000001_polypolish,3760029,3760030,1
2342,Microbacterium saperdae,4,3,Ms43.1,tig00000001_polypolish,3760293,3760295,2
2343,Microbacterium saperdae,4,3,Ms43.1,tig00000001_polypolish,3760889,3761082,193
2344,Microbacterium saperdae,4,5,Ms45.1,tig00000001_polypolish,1,2679,2678
2345,Microbacterium saperdae,4,5,Ms45.1,tig00000001_polypolish,2823,2825,2
2346,Microbacterium saperdae,4,5,Ms45.1,tig00000001_polypolish,2840,2842,2
2347,Microbacterium saperdae,4,5,Ms45.1,tig00000001_polypolish,3095,3096,1
2348,Microbacterium saperdae,4,5,Ms45.1,tig00000001_polypolish,3261,3262,1
2349,Microbacterium saperdae,4,5,Ms45.1,tig00000001_polypolish,3278,3279,1
2350,Microbacterium saperdae,4,5,Ms45.1,tig00000001_polypolish,3340,3341,1
2351,Microbacterium saperdae,4,5,Ms45.1,tig00000001_polypolish,3343,3344,1
2352,Microbacterium saperdae,4,5,Ms45.1,tig00000001_polypolish,3553,3555,2
2353,Microbacterium saperdae,4,5,Ms45.1,tig00000001_polypolish,3703,3705,2
2354,Microbacterium saperdae,4,5,Ms45.1,tig00000001_polypolish,3724,3725,1
2355,Microbacterium saperdae,4,5,Ms45.1,tig00000001_polypolish,5322,5323,1
2356,Microbacterium saperdae,4,5,Ms45.1,tig00000001_polypolish,1837927,1837933,6
2357,Microbacterium saperdae,4,5,Ms45.1,tig00000001_polypolish,1953154,1953158,4
2358,Microbacterium saperdae,4,5,Ms45.1,tig00000001_polypolish,1982264,1982269,5
2359,Microbacterium saperdae,4,5,Ms45.1,tig00000001_polypolish,3759950,3759951,1
2360,Microbacterium saperdae,4,5,Ms45.1,tig00000001_polypolish,3760907,3761082,175
2361,Ochrobactrum anthropi,4,1,Oa41.1,tig00000002_polypolish,1,298,297
2362,Ochrobactrum anthropi,4,1,Oa41.1,tig00000002_polypolish,894,895,1
2363,Ochrobactrum anthropi,4,1,Oa41.1,tig00000002_polypolish,2276581,2276582,1
2364,Ochrobactrum anthropi,4,1,Oa41.1,tig00000002_polypolish,2285333,2285334,1
2365,Ochrobactrum anthropi,4,1,Oa41.1,tig00000002_polypolish,2285434,2285435,1
2366,Ochrobactrum anthropi,4,1,Oa41.1,tig00000002_polypolish,2285716,2285717,1
2367,Ochrobactrum anthropi,4,1,Oa41.1,tig00000002_polypolish,2285824,2285825,1
2368,Ochrobactrum anthropi,4,1,Oa41.1,tig00000002_polypolish,2285992,2285993,1
2369,Ochrobactrum anthropi,4,1,Oa41.1,tig00000002_polypolish,2286082,2286083,1
2370,Ochrobactrum anthropi,4,1,Oa41.1,tig00000002_polypolish,2286124,2286125,1
2371,Ochrobactrum anthropi,4,1,Oa41.1,tig00000002_polypolish,2286199,2286200,1
2372,Ochrobactrum anthropi,4,1,Oa41.1,tig00000002_polypolish,2286234,2286235,1
2373,Ochrobactrum anthropi,4,1,Oa41.1,tig00000002_polypolish,2286342,2286343,1
2374,Ochrobactrum anthropi,4,1,Oa41.1,tig00000002_polypolish,2286376,2288364,1988
2375,Ochrobactrum anthropi,4,1,Oa41.1,tig00000003_polypolish,0,720,720
2376,Ochrobactrum anthropi,4,1,Oa41.1,tig00000003_polypolish,881,882,1
2377,Ochrobactrum anthropi,4,1,Oa41.1,tig00000003_polypolish,939,940,1
2378,Ochrobactrum anthropi,4,1,Oa41.1,tig00000003_polypolish,961,962,1
2379,Ochrobactrum anthropi,4,1,Oa41.1,tig00000003_polypolish,1292,1293,1
2380,Ochrobactrum anthropi,4,1,Oa41.1,tig00000003_polypolish,1364,1365,1
2381,Ochrobactrum anthropi,4,1,Oa41.1,tig00000003_polypolish,1372,1373,1
2382,Ochrobactrum anthropi,4,1,Oa41.1,tig00000003_polypolish,1403,1404,1
2383,Ochrobactrum anthropi,4,1,Oa41.1,tig00000003_polypolish,1520,1521,1
2384,Ochrobactrum anthropi,4,1,Oa41.1,tig00000003_polypolish,1634,1635,1
2385,Ochrobactrum anthropi,4,1,Oa41.1,tig00000003_polypolish,1727,1728,1
2386,Ochrobactrum anthropi,4,1,Oa41.1,tig00000003_polypolish,1734,1735,1
2387,Ochrobactrum anthropi,4,1,Oa41.1,tig00000003_polypolish,2001,2002,1
2388,Ochrobactrum anthropi,4,1,Oa41.1,tig00000003_polypolish,2056,2058,2
2389,Ochrobactrum anthropi,4,1,Oa41.1,tig00000003_polypolish,2083,2084,1
2390,Ochrobactrum anthropi,4,1,Oa41.1,tig00000003_polypolish,2356,2357,1
2391,Ochrobactrum anthropi,4,1,Oa41.1,tig00000003_polypolish,2543,2544,1
2392,Ochrobactrum anthropi,4,1,Oa41.1,tig00000003_polypolish,2646,2648,2
2393,Ochrobactrum anthropi,4,1,Oa41.1,tig00000003_polypolish,2685,2686,1
2394,Ochrobactrum anthropi,4,1,Oa41.1,tig00000003_polypolish,2768,2769,1
2395,Ochrobactrum anthropi,4,1,Oa41.1,tig00000003_polypolish,3161,3162,1
2396,Ochrobactrum anthropi,4,1,Oa41.1,tig00000003_polypolish,3294,3295,1
2397,Ochrobactrum anthropi,4,1,Oa41.1,tig00000003_polypolish,3349,3350,1
2398,Ochrobactrum anthropi,4,1,Oa41.1,tig00000003_polypolish,3373,3374,1
2399,Ochrobactrum anthropi,4,1,Oa41.1,tig00000003_polypolish,3392,3394,2
2400,Ochrobactrum anthropi,4,1,Oa41.1,tig00000003_polypolish,3464,3465,1
2401,Ochrobactrum anthropi,4,1,Oa41.1,tig00000003_polypolish,3836,3837,1
2402,Ochrobactrum anthropi,4,1,Oa41.1,tig00000003_polypolish,3883,3886,3
2403,Ochrobactrum anthropi,4,1,Oa41.1,tig00000003_polypolish,4015,4016,1
2404,Ochrobactrum anthropi,4,1,Oa41.1,tig00000003_polypolish,4042,4043,1
2405,Ochrobactrum anthropi,4,1,Oa41.1,tig00000003_polypolish,4081,4082,1
2406,Ochrobactrum anthropi,4,1,Oa41.1,tig00000003_polypolish,4222,4223,1
2407,Ochrobactrum anthropi,4,1,Oa41.1,tig00000003_polypolish,4430,4431,1
2408,Ochrobactrum anthropi,4,1,Oa41.1,tig00000003_polypolish,4451,4452,1
2409,Ochrobactrum anthropi,4,1,Oa41.1,tig00000003_polypolish,4533,4534,1
2410,Ochrobactrum anthropi,4,1,Oa41.1,tig00000003_polypolish,4948,4949,1
2411,Ochrobactrum anthropi,4,1,Oa41.1,tig00000003_polypolish,5120,5121,1
2412,Ochrobactrum anthropi,4,1,Oa41.1,tig00000003_polypolish,5204,5205,1
2413,Ochrobactrum anthropi,4,1,Oa41.1,tig00000003_polypolish,5244,5245,1
2414,Ochrobactrum anthropi,4,1,Oa41.1,tig00000003_polypolish,5284,5285,1
2415,Ochrobactrum anthropi,4,1,Oa41.1,tig00000003_polypolish,5554,5555,1
2416,Ochrobactrum anthropi,4,1,Oa41.1,tig00000003_polypolish,5560,5561,1
2417,Ochrobactrum anthropi,4,1,Oa41.1,tig00000003_polypolish,7078,7081,3
2418,Ochrobactrum anthropi,4,1,Oa41.1,tig00000003_polypolish,1840463,1840464,1
2419,Ochrobactrum anthropi,4,1,Oa41.1,tig00000003_polypolish,2878148,2879873,1725
2420,Ochrobactrum anthropi,4,1,Oa41.1,tig00000004_polypolish,0,13,13
2421,Ochrobactrum anthropi,4,1,Oa41.1,tig00000004_polypolish,20677,20678,1
2422,Ochrobactrum anthropi,4,1,Oa41.1,tig00000004_polypolish,21077,21078,1
2423,Ochrobactrum anthropi,4,1,Oa41.1,tig00000004_polypolish,21124,21125,1
2424,Ochrobactrum anthropi,4,1,Oa41.1,tig00000004_polypolish,22191,22192,1
2425,Ochrobactrum anthropi,4,1,Oa41.1,tig00000004_polypolish,22355,22356,1
2426,Ochrobactrum anthropi,4,1,Oa41.1,tig00000004_polypolish,22371,22372,1
2427,Ochrobactrum anthropi,4,1,Oa41.1,tig00000004_polypolish,22381,22382,1
2428,Ochrobactrum anthropi,4,1,Oa41.1,tig00000004_polypolish,22450,22451,1
2429,Ochrobactrum anthropi,4,1,Oa41.1,tig00000004_polypolish,22509,22510,1
2430,Ochrobactrum anthropi,4,1,Oa41.1,tig00000004_polypolish,22596,22597,1
2431,Ochrobactrum anthropi,4,1,Oa41.1,tig00000004_polypolish,22743,22744,1
2432,Ochrobactrum anthropi,4,1,Oa41.1,tig00000004_polypolish,23103,23105,2
2433,Ochrobactrum anthropi,4,1,Oa41.1,tig00000004_polypolish,23328,23548,220
2434,Ochrobactrum anthropi,4,1,Oa41.1,tig00000005_polypolish,0,454,454
2435,Ochrobactrum anthropi,4,1,Oa41.1,tig00000005_polypolish,923,924,1
2436,Ochrobactrum anthropi,4,1,Oa41.1,tig00000005_polypolish,1715,1716,1
2437,Ochrobactrum anthropi,4,1,Oa41.1,tig00000005_polypolish,58079,58099,20
2438,Ochrobactrum anthropi,4,1,Oa41.2,tig00000002_polypolish,1,636,635
2439,Ochrobactrum anthropi,4,1,Oa41.2,tig00000002_polypolish,651,652,1
2440,Ochrobactrum anthropi,4,1,Oa41.2,tig00000002_polypolish,2287097,2287098,1
2441,Ochrobactrum anthropi,4,1,Oa41.2,tig00000002_polypolish,2287295,2288364,1069
2442,Ochrobactrum anthropi,4,1,Oa41.2,tig00000003_polypolish,0,1648,1648
2443,Ochrobactrum anthropi,4,1,Oa41.2,tig00000003_polypolish,1917,1919,2
2444,Ochrobactrum anthropi,4,1,Oa41.2,tig00000003_polypolish,2380,2381,1
2445,Ochrobactrum anthropi,4,1,Oa41.2,tig00000003_polypolish,2447,2448,1
2446,Ochrobactrum anthropi,4,1,Oa41.2,tig00000003_polypolish,2732,2733,1
2447,Ochrobactrum anthropi,4,1,Oa41.2,tig00000003_polypolish,2826,2828,2
2448,Ochrobactrum anthropi,4,1,Oa41.2,tig00000003_polypolish,3040,3041,1
2449,Ochrobactrum anthropi,4,1,Oa41.2,tig00000003_polypolish,3116,3117,1
2450,Ochrobactrum anthropi,4,1,Oa41.2,tig00000003_polypolish,3130,3131,1
2451,Ochrobactrum anthropi,4,1,Oa41.2,tig00000003_polypolish,3161,3162,1
2452,Ochrobactrum anthropi,4,1,Oa41.2,tig00000003_polypolish,3553,3554,1
2453,Ochrobactrum anthropi,4,1,Oa41.2,tig00000003_polypolish,3559,3560,1
2454,Ochrobactrum anthropi,4,1,Oa41.2,tig00000003_polypolish,3807,3808,1
2455,Ochrobactrum anthropi,4,1,Oa41.2,tig00000003_polypolish,3864,3865,1
2456,Ochrobactrum anthropi,4,1,Oa41.2,tig00000003_polypolish,4013,4014,1
2457,Ochrobactrum anthropi,4,1,Oa41.2,tig00000003_polypolish,4296,4297,1
2458,Ochrobactrum anthropi,4,1,Oa41.2,tig00000003_polypolish,4493,4494,1
2459,Ochrobactrum anthropi,4,1,Oa41.2,tig00000003_polypolish,4589,4590,1
2460,Ochrobactrum anthropi,4,1,Oa41.2,tig00000003_polypolish,4650,4654,4
2461,Ochrobactrum anthropi,4,1,Oa41.2,tig00000003_polypolish,4655,4656,1
2462,Ochrobactrum anthropi,4,1,Oa41.2,tig00000003_polypolish,4810,4811,1
2463,Ochrobactrum anthropi,4,1,Oa41.2,tig00000003_polypolish,4844,4845,1
2464,Ochrobactrum anthropi,4,1,Oa41.2,tig00000003_polypolish,1904586,1904587,1
2465,Ochrobactrum anthropi,4,1,Oa41.2,tig00000003_polypolish,2876044,2876045,1
2466,Ochrobactrum anthropi,4,1,Oa41.2,tig00000003_polypolish,2876105,2876106,1
2467,Ochrobactrum anthropi,4,1,Oa41.2,tig00000003_polypolish,2876118,2879873,3755
2468,Ochrobactrum anthropi,4,1,Oa41.2,tig00000004_polypolish,0,10,10
2469,Ochrobactrum anthropi,4,1,Oa41.2,tig00000004_polypolish,22460,22461,1
2470,Ochrobactrum anthropi,4,1,Oa41.2,tig00000004_polypolish,22631,22632,1
2471,Ochrobactrum anthropi,4,1,Oa41.2,tig00000004_polypolish,22844,22845,1
2472,Ochrobactrum anthropi,4,1,Oa41.2,tig00000004_polypolish,22942,22943,1
2473,Ochrobactrum anthropi,4,1,Oa41.2,tig00000004_polypolish,23256,23257,1
2474,Ochrobactrum anthropi,4,1,Oa41.2,tig00000004_polypolish,23265,23548,283
2475,Ochrobactrum anthropi,4,1,Oa41.2,tig00000005_polypolish,0,2983,2983
2476,Ochrobactrum anthropi,4,1,Oa41.2,tig00000005_polypolish,3061,3062,1
2477,Ochrobactrum anthropi,4,1,Oa41.2,tig00000005_polypolish,3181,3182,1
2478,Ochrobactrum anthropi,4,1,Oa41.2,tig00000005_polypolish,3358,3359,1
2479,Ochrobactrum anthropi,4,1,Oa41.2,tig00000005_polypolish,3386,3387,1
2480,Ochrobactrum anthropi,4,1,Oa41.2,tig00000005_polypolish,3505,3506,1
2481,Ochrobactrum anthropi,4,1,Oa41.2,tig00000005_polypolish,3883,3884,1
2482,Ochrobactrum anthropi,4,1,Oa41.2,tig00000005_polypolish,3935,3936,1
2483,Ochrobactrum anthropi,4,1,Oa41.2,tig00000005_polypolish,3952,3953,1
2484,Ochrobactrum anthropi,4,2,Oa42.1,tig00000002_polypolish,1,1912,1911
2485,Ochrobactrum anthropi,4,2,Oa42.1,tig00000002_polypolish,2181,2182,1
2486,Ochrobactrum anthropi,4,2,Oa42.1,tig00000002_polypolish,2250,2251,1
2487,Ochrobactrum anthropi,4,2,Oa42.1,tig00000002_polypolish,2549,2550,1
2488,Ochrobactrum anthropi,4,2,Oa42.1,tig00000002_polypolish,2282749,2282750,1
2489,Ochrobactrum anthropi,4,2,Oa42.1,tig00000002_polypolish,2283366,2283367,1
2490,Ochrobactrum anthropi,4,2,Oa42.1,tig00000002_polypolish,2284599,2284600,1
2491,Ochrobactrum anthropi,4,2,Oa42.1,tig00000002_polypolish,2285092,2285093,1
2492,Ochrobactrum anthropi,4,2,Oa42.1,tig00000002_polypolish,2286170,2286171,1
2493,Ochrobactrum anthropi,4,2,Oa42.1,tig00000002_polypolish,2286189,2286190,1
2494,Ochrobactrum anthropi,4,2,Oa42.1,tig00000002_polypolish,2286280,2288364,2084
2495,Ochrobactrum anthropi,4,2,Oa42.1,tig00000003_polypolish,0,5548,5548
2496,Ochrobactrum anthropi,4,2,Oa42.1,tig00000003_polypolish,2877836,2877837,1
2497,Ochrobactrum anthropi,4,2,Oa42.1,tig00000003_polypolish,2878794,2879873,1079
2498,Ochrobactrum anthropi,4,2,Oa42.1,tig00000004_polypolish,0,2210,2210
2499,Ochrobactrum anthropi,4,2,Oa42.1,tig00000004_polypolish,22906,22907,1
2500,Ochrobactrum anthropi,4,2,Oa42.1,tig00000004_polypolish,22916,23548,632
2501,Ochrobactrum anthropi,4,2,Oa42.1,tig00000005_polypolish,0,263,263
2502,Ochrobactrum anthropi,4,2,Oa42.1,tig00000005_polypolish,268,269,1
2503,Ochrobactrum anthropi,4,2,Oa42.1,tig00000005_polypolish,586,587,1
2504,Ochrobactrum anthropi,4,2,Oa42.1,tig00000005_polypolish,781,782,1
2505,Ochrobactrum anthropi,4,2,Oa42.1,tig00000005_polypolish,911,912,1
2506,Ochrobactrum anthropi,4,2,Oa42.1,tig00000005_polypolish,1765,1766,1
2507,Ochrobactrum anthropi,4,2,Oa42.1,tig00000005_polypolish,1926,1927,1
2508,Ochrobactrum anthropi,4,2,Oa42.1,tig00000005_polypolish,2130,2131,1
2509,Ochrobactrum anthropi,4,2,Oa42.1,tig00000005_polypolish,2156,2157,1
2510,Ochrobactrum anthropi,4,2,Oa42.1,tig00000005_polypolish,3279,3280,1
2511,Ochrobactrum anthropi,4,2,Oa42.1,tig00000005_polypolish,3688,3689,1
2512,Ochrobactrum anthropi,4,2,Oa42.1,tig00000005_polypolish,4049,4050,1
2513,Ochrobactrum anthropi,4,2,Oa42.1,tig00000005_polypolish,58060,58099,39
2514,Ochrobactrum anthropi,4,3,Oa43.1,tig00000002_polypolish,1,3252,3251
2515,Ochrobactrum anthropi,4,3,Oa43.1,tig00000002_polypolish,2286658,2286659,1
2516,Ochrobactrum anthropi,4,3,Oa43.1,tig00000002_polypolish,2286693,2286694,1
2517,Ochrobactrum anthropi,4,3,Oa43.1,tig00000002_polypolish,2287008,2287009,1
2518,Ochrobactrum anthropi,4,3,Oa43.1,tig00000002_polypolish,2287022,2287026,4
2519,Ochrobactrum anthropi,4,3,Oa43.1,tig00000002_polypolish,2288038,2288364,326
2520,Ochrobactrum anthropi,4,3,Oa43.1,tig00000003_polypolish,0,2206,2206
2521,Ochrobactrum anthropi,4,3,Oa43.1,tig00000003_polypolish,2320,2321,1
2522,Ochrobactrum anthropi,4,3,Oa43.1,tig00000003_polypolish,2554,2555,1
2523,Ochrobactrum anthropi,4,3,Oa43.1,tig00000003_polypolish,2905,2907,2
2524,Ochrobactrum anthropi,4,3,Oa43.1,tig00000003_polypolish,2951,2953,2
2525,Ochrobactrum anthropi,4,3,Oa43.1,tig00000003_polypolish,3012,3013,1
2526,Ochrobactrum anthropi,4,3,Oa43.1,tig00000003_polypolish,3034,3035,1
2527,Ochrobactrum anthropi,4,3,Oa43.1,tig00000003_polypolish,3373,3374,1
2528,Ochrobactrum anthropi,4,3,Oa43.1,tig00000003_polypolish,3670,3671,1
2529,Ochrobactrum anthropi,4,3,Oa43.1,tig00000003_polypolish,3720,3721,1
2530,Ochrobactrum anthropi,4,3,Oa43.1,tig00000003_polypolish,3957,3958,1
2531,Ochrobactrum anthropi,4,3,Oa43.1,tig00000003_polypolish,3998,3999,1
2532,Ochrobactrum anthropi,4,3,Oa43.1,tig00000003_polypolish,4323,4324,1
2533,Ochrobactrum anthropi,4,3,Oa43.1,tig00000003_polypolish,5084,5085,1
2534,Ochrobactrum anthropi,4,3,Oa43.1,tig00000003_polypolish,5221,5222,1
2535,Ochrobactrum anthropi,4,3,Oa43.1,tig00000003_polypolish,5311,5312,1
2536,Ochrobactrum anthropi,4,3,Oa43.1,tig00000003_polypolish,2877454,2877455,1
2537,Ochrobactrum anthropi,4,3,Oa43.1,tig00000003_polypolish,2878578,2878579,1
2538,Ochrobactrum anthropi,4,3,Oa43.1,tig00000003_polypolish,2878999,2879873,874
2539,Ochrobactrum anthropi,4,3,Oa43.1,tig00000004_polypolish,0,50,50
2540,Ochrobactrum anthropi,4,3,Oa43.1,tig00000004_polypolish,1478,1479,1
2541,Ochrobactrum anthropi,4,3,Oa43.1,tig00000004_polypolish,20548,20549,1
2542,Ochrobactrum anthropi,4,3,Oa43.1,tig00000004_polypolish,20677,20678,1
2543,Ochrobactrum anthropi,4,3,Oa43.1,tig00000004_polypolish,20763,20764,1
2544,Ochrobactrum anthropi,4,3,Oa43.1,tig00000004_polypolish,20989,23548,2559
2545,Ochrobactrum anthropi,4,3,Oa43.1,tig00000005_polypolish,0,1247,1247
2546,Ochrobactrum anthropi,4,3,Oa43.1,tig00000005_polypolish,1257,1258,1
2547,Ochrobactrum anthropi,4,3,Oa43.1,tig00000005_polypolish,1537,1538,1
2548,Ochrobactrum anthropi,4,3,Oa43.1,tig00000005_polypolish,1746,1747,1
2549,Ochrobactrum anthropi,4,3,Oa43.1,tig00000005_polypolish,58079,58099,20
2550,Ochrobactrum anthropi,4,4,Oa44.1,tig00000002_polypolish,1,1023,1022
2551,Ochrobactrum anthropi,4,4,Oa44.1,tig00000002_polypolish,1138,1140,2
2552,Ochrobactrum anthropi,4,4,Oa44.1,tig00000002_polypolish,1392,1393,1
2553,Ochrobactrum anthropi,4,4,Oa44.1,tig00000002_polypolish,2282202,2282203,1
2554,Ochrobactrum anthropi,4,4,Oa44.1,tig00000002_polypolish,2282358,2282359,1
2555,Ochrobactrum anthropi,4,4,Oa44.1,tig00000002_polypolish,2282433,2282434,1
2556,Ochrobactrum anthropi,4,4,Oa44.1,tig00000002_polypolish,2282749,2282750,1
2557,Ochrobactrum anthropi,4,4,Oa44.1,tig00000002_polypolish,2282896,2282897,1
2558,Ochrobactrum anthropi,4,4,Oa44.1,tig00000002_polypolish,2283018,2283019,1
2559,Ochrobactrum anthropi,4,4,Oa44.1,tig00000002_polypolish,2283102,2285462,2360
2560,Ochrobactrum anthropi,4,4,Oa44.1,tig00000002_polypolish,2285512,2285514,2
2561,Ochrobactrum anthropi,4,4,Oa44.1,tig00000002_polypolish,2285534,2285535,1
2562,Ochrobactrum anthropi,4,4,Oa44.1,tig00000002_polypolish,2285541,2285542,1
2563,Ochrobactrum anthropi,4,4,Oa44.1,tig00000002_polypolish,2285767,2285768,1
2564,Ochrobactrum anthropi,4,4,Oa44.1,tig00000002_polypolish,2285780,2285782,2
2565,Ochrobactrum anthropi,4,4,Oa44.1,tig00000002_polypolish,2285824,2285825,1
2566,Ochrobactrum anthropi,4,4,Oa44.1,tig00000002_polypolish,2285843,2285844,1
2567,Ochrobactrum anthropi,4,4,Oa44.1,tig00000002_polypolish,2285877,2285878,1
2568,Ochrobactrum anthropi,4,4,Oa44.1,tig00000002_polypolish,2285959,2285961,2
2569,Ochrobactrum anthropi,4,4,Oa44.1,tig00000002_polypolish,2285966,2285967,1
2570,Ochrobactrum anthropi,4,4,Oa44.1,tig00000002_polypolish,2286121,2288364,2243
2571,Ochrobactrum anthropi,4,4,Oa44.1,tig00000003_polypolish,0,232,232
2572,Ochrobactrum anthropi,4,4,Oa44.1,tig00000003_polypolish,491,492,1
2573,Ochrobactrum anthropi,4,4,Oa44.1,tig00000003_polypolish,609,611,2
2574,Ochrobactrum anthropi,4,4,Oa44.1,tig00000003_polypolish,2050807,2050808,1
2575,Ochrobactrum anthropi,4,4,Oa44.1,tig00000003_polypolish,2879422,2879423,1
2576,Ochrobactrum anthropi,4,4,Oa44.1,tig00000003_polypolish,2879729,2879873,144
2577,Ochrobactrum anthropi,4,4,Oa44.1,tig00000004_polypolish,0,9,9
2578,Ochrobactrum anthropi,4,4,Oa44.1,tig00000004_polypolish,22630,22631,1
2579,Ochrobactrum anthropi,4,4,Oa44.1,tig00000004_polypolish,22743,22744,1
2580,Ochrobactrum anthropi,4,4,Oa44.1,tig00000004_polypolish,22780,22781,1
2581,Ochrobactrum anthropi,4,4,Oa44.1,tig00000004_polypolish,22865,22866,1
2582,Ochrobactrum anthropi,4,4,Oa44.1,tig00000004_polypolish,22912,22913,1
2583,Ochrobactrum anthropi,4,4,Oa44.1,tig00000004_polypolish,23251,23548,297
2584,Ochrobactrum anthropi,4,4,Oa44.1,tig00000005_polypolish,0,2968,2968
2585,Ochrobactrum anthropi,4,4,Oa44.1,tig00000005_polypolish,3406,3407,1
2586,Ochrobactrum anthropi,4,4,Oa44.1,tig00000005_polypolish,3588,3589,1
2587,Ochrobactrum anthropi,4,4,Oa44.1,tig00000005_polypolish,3596,3597,1
2588,Ochrobactrum anthropi,4,4,Oa44.1,tig00000005_polypolish,57041,57042,1
2589,Ochrobactrum anthropi,4,4,Oa44.7,tig00000002_polypolish,1,2112,2111
2590,Ochrobactrum anthropi,4,4,Oa44.7,tig00000002_polypolish,2123,2124,1
2591,Ochrobactrum anthropi,4,4,Oa44.7,tig00000002_polypolish,3668,3669,1
2592,Ochrobactrum anthropi,4,4,Oa44.7,tig00000002_polypolish,2287874,2288364,490
2593,Ochrobactrum anthropi,4,4,Oa44.7,tig00000003_polypolish,0,5548,5548
2594,Ochrobactrum anthropi,4,4,Oa44.7,tig00000003_polypolish,2878152,2878153,1
2595,Ochrobactrum anthropi,4,4,Oa44.7,tig00000003_polypolish,2878256,2878257,1
2596,Ochrobactrum anthropi,4,4,Oa44.7,tig00000003_polypolish,2878541,2878542,1
2597,Ochrobactrum anthropi,4,4,Oa44.7,tig00000003_polypolish,2878893,2878894,1
2598,Ochrobactrum anthropi,4,4,Oa44.7,tig00000003_polypolish,2879047,2879049,2
2599,Ochrobactrum anthropi,4,4,Oa44.7,tig00000003_polypolish,2879081,2879082,1
2600,Ochrobactrum anthropi,4,4,Oa44.7,tig00000003_polypolish,2879110,2879873,763
2601,Ochrobactrum anthropi,4,4,Oa44.7,tig00000004_polypolish,0,10,10
2602,Ochrobactrum anthropi,4,4,Oa44.7,tig00000004_polypolish,22360,22361,1
2603,Ochrobactrum anthropi,4,4,Oa44.7,tig00000004_polypolish,22398,23548,1150
2604,Ochrobactrum anthropi,4,4,Oa44.7,tig00000005_polypolish,0,613,613
2605,Ochrobactrum anthropi,4,5,Oa45.1,tig00000002_polypolish,1,106,105
2606,Ochrobactrum anthropi,4,5,Oa45.1,tig00000002_polypolish,506,507,1
2607,Ochrobactrum anthropi,4,5,Oa45.1,tig00000002_polypolish,597,598,1
2608,Ochrobactrum anthropi,4,5,Oa45.1,tig00000002_polypolish,2287798,2287799,1
2609,Ochrobactrum anthropi,4,5,Oa45.1,tig00000002_polypolish,2287803,2287804,1
2610,Ochrobactrum anthropi,4,5,Oa45.1,tig00000002_polypolish,2287824,2287825,1
2611,Ochrobactrum anthropi,4,5,Oa45.1,tig00000002_polypolish,2287903,2288364,461
2612,Ochrobactrum anthropi,4,5,Oa45.1,tig00000003_polypolish,0,5,5
2613,Ochrobactrum anthropi,4,5,Oa45.1,tig00000003_polypolish,287,288,1
2614,Ochrobactrum anthropi,4,5,Oa45.1,tig00000003_polypolish,2879598,2879599,1
2615,Ochrobactrum anthropi,4,5,Oa45.1,tig00000003_polypolish,2879628,2879873,245
2616,Ochrobactrum anthropi,4,5,Oa45.1,tig00000004_polypolish,0,9,9
2617,Ochrobactrum anthropi,4,5,Oa45.1,tig00000004_polypolish,21760,21761,1
2618,Ochrobactrum anthropi,4,5,Oa45.1,tig00000004_polypolish,22362,22363,1
2619,Ochrobactrum anthropi,4,5,Oa45.1,tig00000004_polypolish,22437,22438,1
2620,Ochrobactrum anthropi,4,5,Oa45.1,tig00000004_polypolish,22597,22598,1
2621,Ochrobactrum anthropi,4,5,Oa45.1,tig00000004_polypolish,22743,22744,1
2622,Ochrobactrum anthropi,4,5,Oa45.1,tig00000004_polypolish,22789,22790,1
2623,Ochrobactrum anthropi,4,5,Oa45.1,tig00000004_polypolish,22804,23548,744
2624,Ochrobactrum anthropi,4,5,Oa45.1,tig00000005_polypolish,0,434,434
2625,Ochrobactrum anthropi,4,5,Oa45.1,tig00000005_polypolish,536,537,1
2626,Ochrobactrum anthropi,4,5,Oa45.1,tig00000005_polypolish,641,642,1
2627,Ochrobactrum anthropi,4,5,Oa45.1,tig00000005_polypolish,748,749,1
2628,Ochrobactrum anthropi,4,5,Oa45.1,tig00000005_polypolish,1110,1111,1
2629,Ochrobactrum anthropi,4,5,Oa45.1,tig00000005_polypolish,1640,1641,1
2630,Ochrobactrum anthropi,4,5,Oa45.1,tig00000005_polypolish,1848,1849,1
2631,Ochrobactrum anthropi,4,5,Oa45.1,tig00000005_polypolish,2129,2130,1
2632,Ochrobactrum anthropi,4,5,Oa45.1,tig00000005_polypolish,58075,58077,2
2633,Ochrobactrum anthropi,4,5,Oa45.1,tig00000005_polypolish,58085,58099,14
2634,Ochrobactrum anthropi,4,5,Oa45.2,tig00000002_polypolish,1,2124,2123
2635,Ochrobactrum anthropi,4,5,Oa45.2,tig00000002_polypolish,2284957,2284958,1
2636,Ochrobactrum anthropi,4,5,Oa45.2,tig00000002_polypolish,2285689,2285690,1
2637,Ochrobactrum anthropi,4,5,Oa45.2,tig00000002_polypolish,2285813,2285815,2
2638,Ochrobactrum anthropi,4,5,Oa45.2,tig00000002_polypolish,2286163,2288364,2201
2639,Ochrobactrum anthropi,4,5,Oa45.2,tig00000003_polypolish,0,333,333
2640,Ochrobactrum anthropi,4,5,Oa45.2,tig00000003_polypolish,370,372,2
2641,Ochrobactrum anthropi,4,5,Oa45.2,tig00000003_polypolish,503,504,1
2642,Ochrobactrum anthropi,4,5,Oa45.2,tig00000003_polypolish,906,907,1
2643,Ochrobactrum anthropi,4,5,Oa45.2,tig00000003_polypolish,927,928,1
2644,Ochrobactrum anthropi,4,5,Oa45.2,tig00000003_polypolish,970,971,1
2645,Ochrobactrum anthropi,4,5,Oa45.2,tig00000003_polypolish,1016,1017,1
2646,Ochrobactrum anthropi,4,5,Oa45.2,tig00000003_polypolish,1422,1423,1
2647,Ochrobactrum anthropi,4,5,Oa45.2,tig00000003_polypolish,1546,1547,1
2648,Ochrobactrum anthropi,4,5,Oa45.2,tig00000003_polypolish,1590,1591,1
2649,Ochrobactrum anthropi,4,5,Oa45.2,tig00000003_polypolish,1789,1790,1
2650,Ochrobactrum anthropi,4,5,Oa45.2,tig00000003_polypolish,2134,2135,1
2651,Ochrobactrum anthropi,4,5,Oa45.2,tig00000003_polypolish,2405,2406,1
2652,Ochrobactrum anthropi,4,5,Oa45.2,tig00000003_polypolish,2878681,2878682,1
2653,Ochrobactrum anthropi,4,5,Oa45.2,tig00000003_polypolish,2879404,2879873,469
2654,Ochrobactrum anthropi,4,5,Oa45.2,tig00000004_polypolish,0,21,21
2655,Ochrobactrum anthropi,4,5,Oa45.2,tig00000004_polypolish,41,42,1
2656,Ochrobactrum anthropi,4,5,Oa45.2,tig00000004_polypolish,1098,1099,1
2657,Ochrobactrum anthropi,4,5,Oa45.2,tig00000004_polypolish,1229,1230,1
2658,Ochrobactrum anthropi,4,5,Oa45.2,tig00000004_polypolish,21491,21492,1
2659,Ochrobactrum anthropi,4,5,Oa45.2,tig00000004_polypolish,21754,21755,1
2660,Ochrobactrum anthropi,4,5,Oa45.2,tig00000004_polypolish,21897,21898,1
2661,Ochrobactrum anthropi,4,5,Oa45.2,tig00000004_polypolish,22406,22407,1
2662,Ochrobactrum anthropi,4,5,Oa45.2,tig00000004_polypolish,22822,22823,1
2663,Ochrobactrum anthropi,4,5,Oa45.2,tig00000004_polypolish,23027,23548,521
2664,Ochrobactrum anthropi,4,5,Oa45.2,tig00000005_polypolish,0,4133,4133
2665,Ochrobactrum anthropi,4,5,Oa45.2,tig00000005_polypolish,58069,58099,30
